~~~~~~~~~~~~~~~~~~~~~~~~~~~~~~~~~~~~~~~~~~~~~~~~~~~~~~~~~~~~~~~~~~~~~~~~~~~~~~~~~~~~~~~~~~~~~~~~~~~~
~~~~~~~~~~~~~~~~~~~~~~~~~~~~~~~~~~~~~~~~~~~~~~~~~~~~~~~~~~~~~~~~~~~~~~~~~~~~~~~~~~~~~~~~~~~~~~~~~~~~
~~~~~~~~~~~~~~~~~~~~~~~~~~~~~~~~~~~~~~~~~~~~~~~~~~~~~~~~~~~~~~~~~~~~~~~~~~~~~~~~~~~~~~~~~~~~~~~~~~~~
~~~~~~~~~~~~~~~~~~~~~~~~~~~~~~~~~~~~~~~~~~~~~~~~~~~~~~~~~~~~~~~~~~~~~~~~~~~~~~~~~~~~~~~~~~~~~~~~~~~~
~~~~~~~~~~~~~~~~~~~~~~~~~~~~~~~~~~~~~~~~~~~~~~~~~~~~~~~~~~~~~~~~~~~~~~~~~~~~~~~~~~~~~~~~~~~~~~~~~~~~
~~~~~~~~~~~~~~~~~~~~~~~~~~~~~~~~~~~~~~~~~~~~~~~~~~~~~~~~~~~~~~~~~~~~~~~~~~~~~~~~~~~~~~~~~~~~~~~~~~~~
~~~~~~~~~~~~~~~~~~~~~~~~~~~~~~~~~~~~~~~~~~~~~~~~~~~~~~~~~~~~~~~~~~~~~~~~~~~~~~~~~~~~~~~~~~~~~~~~~~~~
~~~~~~~~~~~~~~~~~~~~~~~~~~~~~~~~~~~~~~~~~~~~~~~~~~~~~~~~~~~~~~~~~~~~~~~~~~~~~~~~~~~~~~~~~~~~~~~~~~~~
~~~~~~~~~~~~~~~~~~~~~~~~~~~~~~~~~~~~~~~~~~~~~~~~~~~~~~~~~~~~~~~~~~~~~~~~~~~~~~~~~~~~~~~~~~~~~~~~~~~~
~~~~~~~~~~~~~~~~~~~~~~~~~~~~~~~~~~~~~~~~~~~~~~~~~~~~~~~~~~~~~~~~~~~~~~~~~~~~~~~~~~~~~~             .
~~~~~~~~~~~~~~~~~~~~~~~~~~~~~~~~~~~~~~~~~~~~~~~~~~~~~~~~~~~~~~~~~~~~~                              .
~~~~~~~~~~~~~~~~~~~~~~~~~~~~~~~~~~~~~~~~~~~~~~~~~~~~~~~~~~~~~~~                                    .
~~~~~~~~~~~~~~~~~~~~~~~~~~~~~~~~~~~~~~~~~~~~~~~~~~~~~~~                                            .
~~~~~~~~~~~~~~~~~~~~~~~~~~~~~~~~~~~~~~~~~~~~~~~~~~                !                                .
~~~~~~~~~~~~~~~~~~~~~~~~~~~~~~~~~~~~~~~~~~~~~~~~~                                                  .
~~~~~~~~~~~~~~~~~~~~~~~~~~~~~~~~~~~~~~~~~~~~~~~~~                                         !        .
~~~~~~~~~~~~~~~~~~~~~~~~~~~~~~~~~~~~~~~~~~~~~~                                                     .
~~~~~~~~~~~~~~~~~~~~~~~~~~~~~~~~~~~~~~~~~~~~~~                                                     .
~~~~~~~~~~~~~~~~~~~~~~~~~~~~~~~~~~~~~~~~~~~~~~~                                                    .
~~~~~~~~~~~~~~~~~~~~~~~~~~~~~~~~~~~~~~~~~~~~~~~~~~~~                                               .
~~~~~~~~~~~~~~~~~~~~~~~~~~~~~~~~~~~~~~~~~~~~~~~~~~~~~~~                                            .
~~~~~~~~~~~~~~~~~~~~~~~~~~~~~~~~~~~~~~~~~~~~~~~~~~~~~~~                                            .
~~~~~~~~~~~~~~~~~~~~~~~~~~~~~~~~~~~~~~~~~~~~~~~~~~~~~                  ^^^                         .
~~~~~~~~~~~~~~~~~~~~~~~~~~~~~~~~~~~~~~~~~~~~                         ^^^A^^^(((                    .
~~~~~~~~~~~~~~~~~~~~~~~~~~~~~~~~~~~~~~~~~~~                      ^^ ^^   ~^^^((((                  .
~~~~~~~~~~~~~~~~~~~~~~~~~~~~~~~~~~~~~~~~                          ^     ~~~^^((((((                .
~~~~~~~~~~~~~~~~~~~~~~~~~~~~~~~~~~~~~                             ^^^^^~~^^^(((((((((              .
~~~~~~~~~~~~~~~~~~~~~~~~~~~~~~~~~~~                               (((^^^^^^(((((((((((             .
~~~~~~~~~~~~~~~~~~~~~~~~A~~~~~~~~~                                 (((((((((((((((                 .
~~~~~~~~~~~~~~~~~~~~~~~~  ~~~~~                                      ((((((((                      .
~~~~~~~~~~~~~~~~~~~~~~~~~     ~~                !                  ######                          .
~~~~~~~~~~~~~~~~~~~~~~~~~~~                                     #######                            .
~~~~~~~~~~~~~~~~~~~~~~~~~~                                   #######                  !            .
~~~~~~~~~~~~~~~~~~~~~~~~~                                  ######                                  .
~~~~~~~~~~~~~~~~~~~~~~                                   #######                                   .
~~~~~~~~~~~~~~~~~~~~~~                                  ######                                     .
~~~~~~~~~~~~~~~~~~~~                                     ####                                      .
~~~~~~~~~~~~~~~~~~~                                     ####  !                                    .
~~~~~~~~~~~~~~~~~~~                                     ##                                         .
~~~~~~~~~~~~~~~~~~                                    #####                                        .
~~~~~~~~~~~~~~~~~                                   ######                                         .
~~~~~~~~~~~~~~~~                                  #######                                          .
~~~~~~~~~~~~~~~                                  ######                         A~~~~~~~~~~~~~~~~~~~
~~~~~~~~~~~~~~~~                               #######           ~~~~~~~~~~~~~~~~~~~~~~~~~~~~~~~~~~~
~~~~~~~~~~~~~~~~                             ######~~~~~~~~~~~~~~~~~~~~~~~~~~~~~~~~~~~~~~~~~~~~~~~~~
~~~~~~~~~~~~~~~~                            ~~~~~~~~~~~~~~~~~~~~~~~~~~~~~~~~~~~~~~++++++++++++++++++
~~~~~~~~~~~~~~~~~                  ~~~~~~~~~~~~~~~~~~~~~~~~~~~~~~~+++++++++++++++++^^^^^^v^^^^^^^^^^
~~~~~~~~~~~~~~~~~~     ~~~~~~~~~~~~~~~~~~~~~~~~~~~~~+++++++++++++++^^^^^^^^^^^^^^^^^^^^^^vv^^^^^^^^^
~~~~~~~~~~~~~~~~~~~~~~~~~~~~~~~~~~~~~~~~~~~~~1+++++++^^^^^^^^^^^^^^^^^^^^^^^^^^^^^^^^^^^^^v^^^^^^^^^
~~~~~~~~~~~~~~~~~~~~~~~~~~~~~~~~~~~~         ++  ^^^^^^^^^^^^^^^^^^^^^^^^^^^^^^^^^^^^^^^^^v^^^^^^^^^
~~~~~~~~~~~~~~~~~~~~~~~~                    ++  ^^^^^^^^^^^^^^^^^^^^^^^^^^^^^^^^^^^^^^^^^^v^^^^^^^^^
~~~~~~~~~~~~~~~~~~                   !      +  ^^^^^^^^^^^^^^^^^^^^^^^^^^^^^^^^^^^^^^^^^^^vv^^^^^^^^
~~~~~~~~~~~~~~~~                           ++  ^^^^^^^^^^^^^^^^^^^^^^^^^^^^^^^^^^^^^^^^^^^^vv^^^^^^^
~~~~~~~~~~~~~~~~                           +  ^^^^^^^^^^^^^^^^^^^^^^^^^^^^^^^^^^^^^^^^^^^^^^vv^^^^^^
~~~~~~~~~~~~~~~~   !                       +  ^^^^^^^^^^^^^^^^^^^^^^^^^^^^^^^^^^^^^^^^^^^^^^^vv^^^^^
~~~~~~~~~~~~~~~~                           ++ ^^^^^^^^^^^^^^^^^^^^^^^^^^^^^^^^^^^^^^^^^^^^^^^^vv^^^^
~~~~~~~~~~~~~~~                             + ^^^^^^^^^^^^^^^^^^^^^^^^^^^^^^^^^^^^^^^^^^^^^^^^^v^^^^
~~~~~~~~~~~~~~~######                       +  ^^^^^^^^^^^^^^^^^^^^^^^^^^^^^^^^^^^^^^^^^^^^^^^^v^^^^
~~~~~~~~~~~~~~##########                    ++ ^^^^^^^^^^^^^^^^^^^^^^^^^^^^^^^^^^^^^^^^^^^^^^^^v^^^^
~~~~~~~~~~~~~~#############                  + ^^^^^^^^^^^^^^^^^^^^^^^^^^^^^^^^^^^^^^^^^^^^^^^^vv^^^
~~~~~~~~~~~~~~##############                 ++ ^^^^^^^^^^^^^^^^^^^^^^^^^^^^^^^^^^^^^^^^^^^^^^^^v^^^
~~~~~~~~~~~~~~~#############                  ++ ^^^^^^^^^^^^^^^^^^^^^^^^^^^^^^^^^^^^^^^^^^^^^^^v^^^
~~~~~~~~~~~~~~~###############                 + ^^^^^^^^^^^^^^^^^^^^^^^^^^^^^^^^^^^^^^^^^^^^^^^vv^^
~~~~~~~~~~~~~~~~##############                 ++ ^^^^^^^^^^^^^^^^^^^^^^^^^^^^^^^^^^^^^^^^^^^^^^^v^^
~~~~~~~~~~~~~~~~################                + ^^^^^^^^^^^^^^^^^^^^^^^^^^^^^^^^^^^^^^^^^^^^^^^v^^
~~~~~~~~~~~~~~~#################                ++ ^^^^^^^^^^^^^^^^^^^^^^^^^^^^^^^^^^^^^^^^^^^^^^vvv
~~~~~~~~~~~~~~~##################                + ^^^^^^^^^^^^^^^^^^^^^^^^^^^^^^^^^^^^^^^^^^^^^^^^^
~~~~~~~~~~~~~~###################                +  ^^^^^^^^^^^^^^^^^^^^^^^^^^^^^^^^^^^^^^^^^^^^^^^^
~~~~~~~~~~~~~#####################      !        ++ ^^^^^^^^^^^^^^^^^^^^^^^^^^^^^^^^^^^^^^^^^^^^^^^^
~~~~~~~~~~~~~#####################                + ^^^^^^^^^^^^^^^^^^^^^^^^^^^^^^^^^^^^^^^^^^^^^^^^
~~~~~~~~~~~~~~#####################               ++ ^^^^^^^^^^^^^^^^^^^^^^^^^^^^^^^^^^^^^^^^^^^^^^^
~~~~~~~~~~~~~~~####################                + ^^^^^^^^^^^^^^^^^^^^^^^^^^^^^^^^^^^^^^^^^^^^^^^
~~~~~~~~~~~~~~~######################              ++ ^^^^^^^^^^^^^^^^^^^^^^^^^^^^^^^^^^^^^^^^^^^^^^
~~~~~~~~~~~~~~###########^^^#############           + ^^^^^^^^^^^^^^^^^^^^^^^^^^^^^^^^^^^^^^^^^^^^^^
~~~~~~~~~~~~~~###########^A^################        ++ ^^^^^^^^^^^^^^^^^^^^^^^^^^^^^^^^^^^^^^^^^^^^^
~~~~~~~~~~~~~~~##########^#^#####################    +  ^^^^^^^^^^^^^^^^^^^^^^^^^^^^^^^^^^^^^^^^^^^^
~~~~~~~~~~~~~~~^^###################################^+^^^^^^^^^^^^^^^^^^^^^^^^^^^^^^^^^^^^^^^^^^^^^^
~~~~~~~~~~~~~~~~^^^###############################^^^+^^^^^^^^^^^^^^^^^^^^^^^^^^^^^^^^^^^^^^^^^^^^^^
~~~~~~~~~~~~~~~~^^^^^#########################^^^^^^^+^^^^^^^^^^^^^^^^^^^^^^^^^^^^^^^^^^^^^^^^^^^^^^
~~~~~~~~~~~~~~~^^^^^^^######################^^^^^^^^^++^^^^^^^^^^^^^^^^^^^^^^^^^^^^^^^^^^^^^^^^^^^^^
~~~~~~~~~~~~~^^^^^^^^^^###################^^^^^^^^^^^^+^^^^^^^^^^^^^^^^^^^^^^^^^^^^^^^^^^^^^^^^^^^^^
~~~~~~~~~~~~^^^^^^^^^^^^^^^^^^^^^^^^^^^^^^^^^^^^^^^^^^+^^^^^^^^^^^^^^^^^^^^^^^^^^^^^^^^^^^^^^^^^^^^^
~~~~~~~~~~^^^^^^^^^^^^^^^^^^^^^^^^^^^^^^^^^^^^^^^^^^^^+^^^^^^^^^^^^^^^^^^^^^^^^^^^^^^^^^^^^^^^^^^^^^
~~~~~~~~^^^^^^^^^^^^^^^^^^^^^^^^^^^^^^^^^^^^^^^^^^^^^++^^^^^^^^^^^^^^^^^^^^^^^^^^^^^^^^^^^^^^^^^^^^^
~~~~~~~~~~^^^^^^^^^^^^^^^^^^^^^^^^^^^^^^^^^^^^^^^^^^^+^^^^^^^^^^^^^^^^^^^^^^^^^^^^^^^^^^^^^^^^^^^^^^
~~~~~~~~~~~^^^^^^^^^^^^^^^^^^^^^^^^^^^^^^^^^^^^^^^^^^+^^^^^^^^^^^^^^^^^^^^^^^^^^^^^^^^^^^^^^^^^^^^^^
~~~~~~~~~~~^^^^^^^^^^^^^^^^^^^^^^^^^^^^^^^^^^^^^^^^^^+^^^^^^^^^^^^^^^^^^^^^^^^^^^^^^^^^^^^^^^^^^^^^^
~~~~~~~~~~~^^^^^^^^^^^^^^^^^^^^^^^^^^^^^^^^^^^^^^^^^++^^^^^^^^^^^^^^^^^^^^^^^^^^^^^^^^^^^^^^^^^^^^^^
~~~~~~~~~~~~^^^^^^^^^^^^^^^^^^^^^^^^^^^^^^^^^^^^^^^^+^^^^^^^^^^^^^^^^^^^^^^^^^^^^^^^^^^^^^^^^^^^^^^^
~~~~~~~~~~~~~^^^^^^^^^^^^^^^^^^^^^^^^^^^^^^^^^^^^^^^+^^^^^^^^^^^^^^^^^^^^^^^^^^^^^^^^^^^^^^^^^^^^^^^
~~~~~~~~~~~~~^^^^^^^^^^^^^^^^^^^^^^^^^^^^^^^^^^^^^^++^^^^^^^^^^^^^^^^^^^^^^^^^^^^^^^^^^^^^^^^^^^^^^^
~~~~~~~~~~~~^^^^^^^^^^^^^^^^^^^^^^^^^^^^^^^^^^^^^^^+^^^^^^^^^^^^^^^^^^^^^^^^^^^^^^^^^^^^^^^^^^^^^^^^
~~~~~~~~~~~^^^^^^^^^^^^^^^^^^^^^^^^^^^^^^^^^^^^^^^++^^^^^^^^^^^^^^^^^^^^^^^^^^^^^^^^^^^^^^^^^^^^^^^^
~~~~~~~~~~~^^^^^^^^^^^^^^^^^^^^^^^^^^^^^^^^^^^^^^^+^^^^^^^^^^^^^^^^^^^^^^^^^^^^^^^^^^^^^^^^^^^^^^^^^
~~~~~~~~~~~~^^^^^^^^^^^^^^^^^^^^^^^^^^^^^^^^^^^^^++^^^^^^^^^^^^^^^^^^^^^^^^^^^^^^^^^^^^^^^^^^^^^^^^^
~~~~~~~~~~~^^^^^^^^^^^^^^^^^^^^^^^^^^^^^^^^^^^^^^+^^^^^^^^^^^^^^^^^^^^^^^^^^^^^^^^^^^^^^^^^^^^^^^^^^
~~~~~~~~~~^^^^^^^^^^^^^^^^^^^^^^^^^^^^^^^^^^-----+----------^^^^^^^^^^^^^^^^^^^^^^^^^^^^^^^^^^^^^^^^
~~~~~~~~~~^^^^^^^^^^^^^^^^^^^^^^^^^^-------------+-------------^^^^^^^^^^^^^^^^^^^^^^^^^^^^^^^^^^^^^
~~~~~~~~~~^^^^^^^^^^^^^^^^^^^^^^^^---------------+---------------^^^^^^^^^^^^^^^^^^^^^^^^^^^^^^^^^^^
~~~~~~~~~^^^^^^^^^^^^^^^^^^^^^^^-----------------+----------------^^^^^^^^^^^^^^^^^^^^^^^^^^^^^^^^^^
