~~~~~~~~~~~~~~~~~~~~~~~~~~~~~~~~~~~~~~~~~~~~~~~~~~~~~~~~~~~~~~~~~~~~~~~~~~~~~~~~~~~~~~~~~~~~~~~~~~~~
~~~~~~~~~~~~~~~~~~~~~~~~~~~~~~~~~~~~~~~~~~~~~~~~~~~~~~~~~~~~~~~~~~~~~~~~~~~~~~~~~~~~~~~~~~~~~~~~~~~~
~~~~~~~~~~~~~~~~~~~~~~~~~~~~~~~~~~~~~~~~~~~~~~~~~~~~~~~~~~~~~~~~~~~~~~~~~~~~~~~~~~~~~~~~~~~~~~~~~~~~
~~~~~~~~~~~~~~~~~~~~~~~~~~~~~~~~~~~~~~~~~~~~~~~~~~~~~~~~~~~~~~~~~~~~~~~~~~~~~~~~~~~~~~~~~~~~~~~~~~~~
~~~~~~~~~~~~~~~~~~~~~~~~~~~~~~~~~~~~~~~~~~~~~~~~~~~~~~~~~~~~~~~~~~~~~~~~~~~~~~~~~~~~~~~~~~~~~~~~~~~~
~~~~~~~~~~~~~~~~~~~~~~~~~~~~~~~~~~~~~~~~~~~~~~~~~~~~~~~~~~~~~~~~~~~~~~~~~~~~~~~~~~~~~~~~~~~~~~~~~~~~
~~~~~~~~~~~~~~~~~~~~~~~~~~~~~~~~~~~~~~~~~~~~~~~~~~~~~~~~~##~~~~~~~~~~~~~~~~~~~~~~~~~~~~~~~~~~~~~~~~~
~~~~~~~~~~~~~~~~~~#####~~~~~~~~~~~~~~~~~~~~~~~~~~~~~###########~~~~~~~~~~~~~~~~~~~~~~~~~~~~~~~~~~~~~
~~~~~~~~~~~~~###############~~~~~~~~~~~~~~~~~~~~###################~~~~~~~~~~~~~~~~~~~~~~~~~~~~~~~~~
################################~~~~~~~~~~~~#########################~~~~~~~~~~~~~~~~~~~~~~~~~~~~~~~
#######################################################################~~~~~~~~~~~~~~~~~~~~~~~~~~~~~
###########################################################################~~~~~~~~~~~~~~~~~~~~~~~~~
##############################################################################~~~~~~~~~~~~~~~~~~~~~~
###################################################################################~~~~~~~~~~~~~~~~~
#################################################################################~~~~~~~~~~~~~~~~~~~
###########################################################A######################~~~~~~~~~~~~~~~~~~
####################################################################################~~~~~~~~~~~~~~~~
###################################################################################~~~~~~~~~~~~~~~~~
##################################################################################~~~~~~~~~~~~~~~~~~
###################################################################################~~~~~~~~~~~~~~~~~
###################################################################################~~~~~~~~~~~~~~~~~
##################################################################################~~~~~~~~~~~~~~~~~~
#################################################################################~~~~~~~~~~~~~~~~~~~
#################################################################################~~~~~~~~~~~~~~~~~~~
#################################################################################~~~~~~~~~~~~~~~~~~~
##################################################################################~~~~~~~~~~~~~~~~~~
#################################################################################~~~~~~~~~~~~~~~~~~~
################################################################################~~~~~~~~~~~~~~~~~~~~
###############################################################################~~~~~~~~~~~~~~~~~~~~~
############################################################################~~~~~~~~~~~~~~~~~~~~~~~~
########################################################################~~~~~~~~~~~~~~~~~~~~~~~~~~~~
####################################################################~~~~~~~~~~~~~~~~~~~~~~~~~~~~~~~~
#################################################################~~~~~~~~~~~~~~~~~~~~~~~~~~~~~~~~~~~
###############################################################~~~~~~~~~~~~~~~~~~~~~~~~~~~~~~~~~~~~~
#############################################################~~~~~~~~~~~~####~~~~~~~~~~~~~~~~~~~~~~~
###########################################################~~~~~~~~~~#########~~~~~~~~~~~~~~~~~~~~~~
#######################################################~~~~~~~~~~~=======######~~~~~~~~~~~~~~~~~~~~~
###################################################~~~~~~~~~~~~~============#####~~~~~~~~~~~~~~~~~~~
################################################~~~~~~~~~~~~~~================####~~~~~~~~~~~~~~~~~~
############################################~~~~~~~~~~~~~~~~====================######~~~~~~~~~~~~~~
##################################~~~~~~~~~~~~~~~~~~~~~~===========================####~~~~~~~~~~~~~
##########################~~~~~~~~~~~~~~~~~~~~~~~~~~=================================#####~~~~~~~~~~
################~~~~~~~~~~~~~~~~~~~~~~~~~~~~~~~~=====================================######~~~~~~~~~
######~~~~~~~~~~~~~~~~~~~~~~~~~~~~~~~~~~~~~~=======================================#####~~~~~~~~~~~~
~~~~~~~~~~~~~~~~~~~~~~~~~~~~~~~~~~~~~~~~~~~(========================================###~~~~~~~~~~~~~
~~~~~~~~~~~~~~~~~~~~~~~~~~~~~~~~~~~~~~~~~~~(========================================###~~~~~~~~~~~~~
~~~~~~~~~~~~~~~~~~~~~~~~~~~~~~~~~~~~~~~~~~~(=========================================###~~~~~~~~~~~~
~~~~~~~~~~~~~~~~~~~~~~~~~~~~~~~~~~~~~~~~~~((=========================================###~~~~~~~~~~~~
~~~~~~~~~~~~~~~~~~~~~~~~~~~~~~~~~~~~~~~~^((((=======================================###~~~~~~~~~~~~~
~~~~~~~~~~~~~~~~~~~~~~~~~~~~~~~~~~~~~~~^^^((((======================================###~~~~~~~~~~~~~
~~~~~~~~~~~~~~~~~~~~~~~~~~~~~~~~~~~~~~^^^^((((=======================================###~~~~~~~~~~~~
~~~~~~~~~~~~~~~~~~~~~~~~~~~~~~~~~~~~~^^^^^^((((=======================================###~~~~~~~~~~~
~~~~~~~~~~~~~~~~~~~~~~~~~~~~~~~~~~~~^^^^^^^((((========================================###~~~~~~~~~~
~~~~~~~~~~~~~~~~~~~~~~~~~~~~~~~~~~~^^^^^^^((((((===================  =================####~~~~~~~~~~
~~~~~~~~~~~~~~~~~~~~~~~~~~~~~~~~~~^^^^^^^^^^((((================== A  ===============####~~~~~~~~~~~
~~~~~~~~~~~~~~~~~~~~~~~~~~~~~~~~~^^^^^^^^^^^^((((==================  ================###~~~~~~~~~~~~
~~~~~~~~~~~~~~~~~~~~~~~~~~~~~~~^^^^^^^^^^^^^^^^(((==================================###~~~~~~~~~~~~~
~~~~~~~~~~~~~~~~~~~~~~~~~~~~~^^^^^^^^^^^^^^^^^^((((================================###~~~~~~~~~~~~~~
~~~~~~~~~~~~~~~~~~~~~~~~~~~^^^^^^^^^^^^^^^^^^^^((((===============================###~~~~~~~~~~~~~~~
~~~~~~~~~~~~~~~~~~~~~~~~^^^^^^^^^^^^^^^^^^^^^^^^((((==============================###~~~~~~~~~~~~~~~
~~~~~~~~~~~~~~~~~~~~~^^^^^^^^^^^^^^^^^^^^^^^^^^^(((((==============================###~~~~~~~~~~~~~~
~~~~~~~~~~~~~~~~~~~^^^^^^^^^^^^^^^^^^^^^^^^^^^^^(((((==============================###~~~~~~~~~~~~~~
~~~~~~~~~~~~~~~~~^^^^^^^^^^^^^^^^^^^^^^^^^^^^^^^^(((((============================###~~~~~~~~~~~~~~~
~~~~~~~~~~~~~~~^^^^^^^^^^^^^^^^^^^^^^^^^^^^^^^^^^^(((((===========================##~~~~~~~~~~~~~~~~
~~~~~~~~~~~~~^^^^^^^^^^^^^^^^^^^^^^^^^^^^^^^^^^^^^(((((==========================###~~~~~~~~~~~~~~~~
~~~~~~~~~~~~^^^^^^^^^^^^^^^^^^^^^^^^^^^^^^^^^^^^^^^(((((========================####~~~~~~~~~~~~~~~~
~~~~~~~~~~^^^^^^^^^^^^^^^^^^^^^^^^^^^^^^^^^^^^^^^^^^^((((=====================#####~~~~~~~~~~~~~~~~~
~~~~~~~~  ^^^^^^^^^^^^^^^^^^^^^^^^^^^^^^^^^^^^^^^^^^^^(((((================#######~~~~~~~~~~~~~~~~~~
~~~~~~~   ^^^^^^^^^^^^^^^^^^^^^^^^^^^^^^^^^^^^^^^^^^^^^^((((============##########~~~~~~~~~~~~~~~~~~
~~~~~     ^^^^^^^^^^^^^^^^^^^^^^^^^^^^^^^^^^^^^^^^^^^^^^(((((========############~~~~~~~~~~~~~~~~~~~
~~~       ^^^^^^^^^^^^^^^^^^^^^^^^^^^^^^^^^^^^^^^^^^^^^A((((((###################~~~~~~~~~~~~~~~~~~~
           ^^^^^^^^^^^^^^^^^^^^^^^^^^^^^^^^^^^^^^^^^^^^^(((((((###################~~~~~~~~~~~~~~~~~~
           ^^^^^^^^^^^^^^^^^^^^^^^^^^^^^^^^^^^^^^^^^^^^^^^((((((###################~~~~~~~~~~~~~~~~~
           ^^^^^^^^^^^^^^^^^^^^^^^^^^^^^^^^^^^^^^^^^^^^^^^^(((((###################~~~~~~~~~~~~~~~~~
           ^^^^^^^^^^^^^^^^^^^^^^^^^^^^^^^^^^^^^^^^^^^^^^^^^(((((###################~~~~~~~~~~~~~~~~
            ^^^^^^^^^^^^^^^^^^^^^^^^^^^^^^^^^^^^^^^^^^^^^^^^((((((##################~~~~~~~~~~~~~~~~
            ^^^^^^^^^^^^^^^^^^^^^^^^^^^^^^^^^^^^^^^^^^^^^^^^^(((((###################~~~~~~~~~~~~~~~
            ^^^^^^^^^^^^^^^^^^^^^^^^^^^^^^^^^^^^^^^^^^^^^^^^^^((((((##################~~~~~~~~~~~~~~
            ^^^^^^^^^^^^^^^^^^^^^^^^^^^^^^^^^^^^^^^^^^^^^^^^^^^((((((###############A###~~~~~~~~~~~~
            ^^^^^^^^^^^^^^^^^^^^^^^^^^^^^^^^^^^^^^^^^^^^^^^^^^^^^((((((################~~~~~~~~~~~~~
            ^^^^^^^^^^^^^^^^^^^^^^^^^^^^^^^^^^^^^^^^^^^^^^^^^^^^^^^((((((##########~~~~~~~~~~~~~~~~~
           ^^^^^^^^^^^^^^^^^^^^^^^^^^^^^^^^^^^^^^^^^^^^^^^^^^^^^^^^^^(((((((#####~~~~~~~~~~~~~~~~~~~
           ^^^^^^^^^^^^^^^^^^^^^^^^^^^^^^^^^^^^^^^^^^^^^^^^^^^^^^^^^^^((((((((((~~~~~~~~~~~~~~~~~~~~
           ^^^^^^^^^^^^^^^^^^^^^^^^^^^^^^^^^^^^^^^^^^^^^^^^^^^^^^^^^^^^^((((((((~~~~~~~~~~~~~~~~~~~~
          ^^^^^^^^^^^^^^^^^^^^^^^^^^^^^^^^^^^^^^^^^^^^^^^^^^^^^^^^^^^^^^^^(((((((~~~~~~~~~~~~~~~~~~~
          ^^^^^^^^^^^^^^^^^^^^^^^^^^^^^^^^^^^^^^^^^^^^^^^^^^^^^^^^^^^^^^^^(((((((~~~~~~~~~~~~~~~~~~~
          ^^^^^^^^^^^^^^^^^^^^^^^^^^^^^^^^^^^^^^^^^^^^^^^^^^^^^^^^^^^^^^^^^((((((~~~~~~~~~~~~~~~~~~~
          ^^^^^^^^^^^^^^^^^^^^^^^^^^^^^^^^^^^^^^^^^^^^^^^^^^^^^^^^^^^^^^^^^(((((((~~~~~~~~~~~~~~~~~~
         ^^^^^^^^^^^^^^^^^^^^^^^^^^^^^^^^^^^^^^^^^^^^^^^^^^^^^^^^^^^^^^^^^^(((((((~~~~~~~~~~~~~~~~~~
         ^^^^^^^^^^^^^^^^^^^^^^^^^^^^^^^^^^^^^^^^^^^^^^^^^^^^^^^^^^^^^^^^^^^((((((~~~~~~~~~~~~~~~~~~
         ^^^^^^^^^^^^^^^^^^^^^^^^^^^^^^^^^^^^^^^^^^^^^^^^^^^^^^^^^^^^^^^^^^^^((((~~~~~~~~~~~~~~~~~~~
        ^^^^^^^^^^^^^^^^^^^^^^^^^^^^^^^^^^^^^^^^^^^^^^^^^^^^^^^^^^^^^^^^^^^^^^^((~~~~~~~~~~~~~~~~~~~
        ^^^^^^^^^^^^^^^^^^^^^^^^^^^^^^^^^^^^^^^^^^^^^^^^^^^^^^^^^^^^^^^^^^^^^^^(~~~~~~~~~~~~~~~~~~~~
        ^^^^^^^^^^^^^^^^^^^^^^^^^^^^^^^^^^^^^^^^^^^^^^^^^^^^^^^^^^^^^^^^^^^^^^^^~~~~~~~~~~~~~~~~~~~~
       ^^^^^^^^^^^^^^^^^^^^^^^^^^^^^^^^^^^^^^^^^^^^^^^^^^^^^^^^^^^^^^^^^^^^^^^^^^~~~~~~~~~~~~~~~~~~~
       ^^^^^^^^^^^^^^^^^^^^^^^^^^^^^^^^^^^^^^^^^^^^^^^^^^^^^^^^^^^^^^^^^^^^^^^^^^^~~~~~~~~~~~~~~~~~~
       ^^^^^^^^^^^^^^^^^^^^^^^^^^^^^^^^^^^^^^^^^^^^^^^^^^^^^^^^^^^^^^^^^^^^^^^^^^^~~~~~~~~~~~~~~~~~~
      ^^^^^^^^^^^^^^^^^^^^^^^^^^^^^^^^^^^^^^^^^^^^^^^^^^^^^^^^^^^^^^^^^^^^^^^^^^^^^~~~~~~~~~~~~~~~~~
      ^^^^^^^^^^^^^^^^^^^^^^^^^^^^^^^^^^^^^^^^^^^^^^^^^^^^^^^^^^^^^^^^^^^^^^^^^^^^^~~~~~~~~~~~~~~~~~
      ^^^^^^^^^^^^^^^^^^^^^^^^^^^^^^^^^^^^^^^^^^^^^^^^^^^^^^^^^^^^^^^^^^^^^^^^^^^^~~~~~~~~~~~~~~~~~~
