~~~~~~~~~~~~~~~~~~~~~~~~~~~~~~~~~~~~~~~~~~~~~~~~~~~~~~~~~~~~~~~~~~~~~~~~~~~~~~~~~~~~~~~~~~~~~~~~~~~~
~~~~~~~~~~~~~~~~~~~~~~~~~~~~~~~~~~~~~~~~~~~~~~~~~~~~~~~~~~~~~~~~~~~~~~~~~~~~~~~~~~~~~~~~~~~~~~~~~~~~
~~~~~~~~~~~~~~~~~~~~~~~~~~~~~~~~~~~~~~~~~~~~~~~~~~~~~~~~~~~~~~~~~~~~~~~~~~~~~~~~~~~~~~~~~~~~~~~~~~~~
~~~~~~~~~~~~~~~~~~~~~~~~~~~~~~~~~~~~~~~~~~~~~~~~~~~~~~~~~~~~~~~~~~~~~~~~~~~~~~~~~~~~~~~~~~~~~~~~~~~~
~~~~~~~~~~~~~~~~~~~~~~~~~~~~~~~~~~~~~~~~~~~~~~~~~~~~~~~~~~~~~~~~~~~~~~~~~~~~~~~~~~~~~~~~~~~~~~~~~~~~
~~~~~~~~~~~~~~~~~~~~~~~~~~~~~~~~~~~~~~~~~~~~~~~~~~~~~~~~~~~~~~~~~~~~~~~~~~~~~~~~~~~~~~~~~~~~~~~~~~~~
~~~~~~~~~~~~~~~~~~~~~~~~~~~~~~~~~~~~~~~~~~ !  ~~~~~~~~~~~~~~~~~~~~~~~~~~~~~~~~~~~~~~~~~~~~~~~~~~~~~~
~~~~~~~~~~~~~~~~~~~~~~~~~~~~~~~~~~~~~~~~      ~~~~~~~~~~~~~~~~~~  ~~~~~~~~~~~~~~~~~~~~~~~~~~~~~~~~~~
~~~~~~~~~~~~~~~~~~~~~~~~~~~~~~~~~~~~~~~      ~~~~~~~~~~~~~~~~~~      ~~~~~~~~~~####~~~~~~~~~~~~~~~~~
      ~~~~~~~~~~~~~~~~~~~~~~~~~~~~~~~~~~    ~~~~~~~~~~~~~~~~~~        ~~~~~~~~~#####~~~~~~~~~~~~~~##
                              ~~~~~~~~          ~~~~~~~~~~~~~            ~~~############~~~~~#######
                                                      ~~~~~                 ########################
                      !                                                      #######################
                                                                              ######################
                                                                !              #####################
   !                                                                            ####################
                                                                                 ###################
                                              !                                   ##################
                                                                                  ##################
                               #####                                             ###################
                           ##########                                            ###################
                        ##############                                            ##################
                      ################   !                                       ###################
                    ###################                                        #####################
                   ###########^^########                                     #######################
                   ##########^^^^########                                 ##########################
                    #######^^^^^^^########                                ##########################
           !        #####^^^vvvA^^^^######                          !      #########################
                     ###^^vvv^^^^vv########                                #########################
                     ###^vv^^^^^vv^########                                 ########################
                    ####^v^^^^vvv^^########                                 ########################
                   ####^^v^^vvv^^^########                                  ########################
                  ####^^^vvvv^^^#########        !                           #######################
    !           ########^^^^^^#########                                      #######################
               ######################                                         ######################
               ######################                                      !  ######################
              #######################                                          #####################
               #####################                                           #####################
                 ##################                       !                   ######################
                      ##########                                            ########################
                                                                        ############################
                                                                    ################################
~~~~~~~~~~~~~~~~~~~~~~~                                         ##################~~~~~~~###########
~~~~~~~~~~~~~~~~~~~~~~~~~~~~~~~~~~~~~~~~~~~~~~~~~~~~~         #################~~~~~~~~~~~~~~~######
~~~~~~~~~~~~~~~~~~~~~~~~~~~~~~~~~~~~~~~~~~~~~~~~~~~~~~~~~~~~~~~~~~~~~~~~~~~~~~~~~~~~~~~~~~~~~~~~~~~~
++++++++++++++++++++++~~~~~~~~~~~~~~~~~~~~~~~~~~~~~~~~~~~~~~~~~~~~~~~~~~~~~~~~~~~~~~~~~~~~~~~~~~~~~~
^^^^^^^^^^^^^^^^^^v^^+++++++++++++++++++++++++++++++++~~~~~~~~~~~~~~~~~~~~~~~~~~~~~~~~~~~~~~~~~~~~~~
^^^^^^^^^^^^^^^^^^v^^^^^^^^^^^^^^^^^^^^^^^^^^^v^^^^^^++++++++++++++++++++++~~~~~~~~~~~~~~~~~~~~~~~~~
^^^^^^^^^^^^^^^^^^vv^^^^^^^^^^^^^^^^^^^^^^^^^^v^^^^^^^^^^^^^^^^^^^^^^^^^^^+++~~~~~~~~~~~~~~~~~~~~~~~
^^^^^^^^^^^^^^^^^^^v^^^^^^^^^^^^^^^^^^^^^^^^^^vv^^^^^^^^^^^^^^^^^^^^^^^^^^^(+~~~~~~~~~~~~~~~~~~~~~~~
^^^^^^^^^^^^^^^^^^^vv^^^^^^^^^^^^^^^^^^^^^^^^^^v^^^^^^^^^^^^^^^^^^^^^^^^^^^(++~~~~~~~~~~~~~~~~~~~~~~
^^^^^^^^^^^^^^^^^^^^v^^^^^^^^^^^^^^^^^^^^^^^^^^v^^^^^^^^^^^^^^^^^^^^^^^^^^^( +~~~~~~~~~~~~~~~~~~~~~~
^^^^^^^^^^^^^^^^^^^^vv^^^^^^^^^^^^^^^^^^^^^^^^^vv^^^^^^^^^^^^^^^^^^^^^^^^^^((+~~~~~~~~~~~~~~~~~~~~~~
^^^^^^^^^^^^^^^^^^^^^v^^^^^^^^^^^^^^^^^^^^^^^^^^v^^^^^^^^^^^^^^^^^^^^^^^^^^^(++~~~~~~~~~~~~~~~~~~~~~
^^^^^^^^^^^^^^^^^^^^^v^^^^^^^^^A ^^^^^^^^^^^^^^^v^^^^^^^^^^^^^^^^^^^^^^^^^^^( +~~~~~~~~~~~~~~~~~~~~~
^^^^^^^^^^^^^^^^^^^^^vv^^^^^^^^  ~~^^^^^^^^^^^^^vv^^^^^^^^^^^^^^^^^^^^^^^^^^((++~~~~~~~~~~~~~~~~~~~~
^^^^^^^^^^^^^^^^^^^^^^v^^vvvv^vv ~~^^^^^^^^^^^^^^v^^^^^^^^^^^^^^^^^^^^^^^^^^(( +~~~~~~~~~~~~~~~~~~~~
^^^^^^^^^^^^^^^^^^^^^^vvvv^^vvv^^ ~^^^^^^^^^^^^^^vv^^^^^^^^^^^^^^^^^^^^^^^^^^( ++~~~~~~~~~~~~~~~~~~~
^^^^^^^^^^^^^^^^^^^^^^^v^^^^^^^^^ ~~~^^^^^^^^^^^^^v^^^^^^^^^^^^^^^^^^^^^^^^^^(( +~~~~~~~~~~~~~~~~~~~
^^^^^^^^^^^^^^^^^^^^^^^v^^^^^^^^^^  ~^^^^^^^^^^^^^v^^^^^^^^^^^^^^^^^^^^^^^^^^(( ++~~~~~~~~~~~~~~~~~~
^^^^^^^^^^^^^^^^^^^^^^^vv^^^^^^^^^^  ^^^^^^^^^^^^^vv^^^^^^^^^^^^^^^^^^^^^^^^^((  +~~~~~~~~~~~~~~~~~~
^^^^^^^^^^^^^^^^^^^^^^^^v^^^^^^^^^^^v^^^^^^^^^^^^^^v^^^^^^^^^^^^^^^^^^^^^^^^^((  +~~~~~~~~~~~~~~~~~~
^^^^^^^^^^^^^^^^^^^^^^^^v^^^^^^^^^^^v^^^^^^^^^^^^^^vv^^^^^^^^^^^^^^^^^^^^^^^^^(##++~~~~~~~~~~~~~~~~~
^^^^^^^^^^^^^^^^^^^^^^^^vv^^^^^^^^^^vv^^^^^^^^^^vvvvv^^^^^^^^^^^^^^^^^^^^^^^^^((# +~~~~~~~~~~~~~~~~~
^^^^^^^^^^^^^^^^^^^^^^^^^v^^^^^^^^^^^v^^^^^^^vvvv^^^v^^^^^^^^^^^^^^^^^^^^^^^^^((##++~~~~~~~~~~~~~~~~
vv^^^^^^^^^^^^^^^^^^^^^^^vv^^^^^^^^^^vv^^^vvvv^^^^^^vv^^^^^^^^^^^^^^^^^^^^^^^^((###++~~~~~~~~~~~~~~~
^v^^^^^^^^^^^^^^^^^^^^^^^^v^^^^^^^^^^^vvvvv^^^^^^^^^^v^^^^^^^^^^^^^^^^^^^^^^^^^((###+~~~~~~~~~~~~~~~
^v^^^^^^^^^^^^^^^^^^^^^^^^v^^^^^^^^^^^v^^^^^^^^^^^^^^vv^^^^^^^^^^^^^^^^^^^^^^^^^(###++~~~~~~~~~~~~~~
^v^^^^^^^^^^^^^^^^^^^^^^^^vv^^^^^^^^^^vv^^^^^^^^^^^^^^v^^^^^^^^^^^^^^^^^^^^^^^^^(####+~~~~~~~~~~~~~~
^v^^^^^^^^^^^^^^^^^^^^^^^^^v^^^^^^^^^^^vv^^^^^^^^^^^^^v^^^^^^^^^^^^^^^^^^^^^^^^^((###+++~~~~~~~~~~~~
^v^^^^^^^^^^^^^^^^^^^^^^^^^v^^^^^^^^^^^^v^^^^^^^^^^^^^v^^^^^^^^^^^^^^^^^^^^^^^^^((#### ++~~~~~~~~~~~
^vv^^^^^^^^^^^^^^^^^^^^^^^^v^^^^^^^^^^^^v^^^^^^^^^^^^^v^^^^^^^^^^^^^^^^^^^^^^^^^((##### +~~~~~~~~~~~
^^v^^^^^^^^^^^^^^^^^^^^^^^^vv^^^^^^^^^^^  ^^^^^^^^^^^^v^^^^^^^^^^^^^^^^^^^^^^^^^^(######+++~~~~~~~~~
^^v^^^^^^^^^^^^^^^^^^^^^^^^^vv^^^^^^^^^^^  ^^^^^^^^^^^v^^^^^^^^^^^^^^^^^^^^^^^^^^((###### ++~~~~~~~~
^^v^^^^^^^^^^^^^^^^^^^^^^^^^^vv^^^^^^^^^^^  ^^^^^^^^^^vv^^^^^~~ ^^^^^^^^^^^^^^^^^^(######  ++~~~~~~~
^^v^^^^^^^^^^^^^^^^^^^^^^^^^^^v^^^^^^^^^^^^ A^^^^^^^^^^v^^^^^~1 %%%%%%%%^^^^^^^^^^(#######  +++~~~~~
^^v^^^^^^^^^^^^^^^^^^^^^^^^^vvv^^^^^^^^^^^^ ^^^^^^^^^^^v^^^^~~         %^^^^^^^^^^((#######   ++~~~~
^^v^^^^^^^^^^^^^^^^^^^^^^^vvv^vv^^^^^^^^^^^ ^^^^^^^^^^^vv^^^~~ ~%%%%%% %^^^^^^^^^^((########   ++~~~
^^v^^^^^^^^^^^^^^^^^^^^^vvv^^^^v^^^^^^^^^^  ^^^^^^^^^^^^v^^^~~~~^^^^^^ %^^^^^^^^^^^(#########   ++++
^^v^^^^^^^^^^^^^^^^^^^vvv^^^^^^v^^^^^^^^^  ^^^^^^^^^^^^^v^^^^^^^^^^^^% %^^^^^^^^^^^((#########     .
^^vv^^^^^^^^^^^^^^^^vvv^^^^^^^^vv^^^^^^^^^ ^^^^^^^^^^^^^vv^^^^^^^^^^^% %^^^^^^^^^^^^(#########     .
^^^v^^^^^^^^^^^^^^^^v^^^^^^^^^^^v^^^^^^^vv  ^^^^^^^^^^^^^v^^^^^^^^^^^% %^^^^^^^^^^^^((#########    .
^^^v^^^^^^^^^^^^^^^^ ^^^^^^^^^^^v^^^^^vvv^^ ^^^^^^^^^^^^^vv^^^^^^^^^^% %%^^^^^^^^^^^((##########   .
^^^vv^^^^^^^^^^^^^^  ^^^^^^^^^^^v^^^vvv^^^^  ^^^^^^^^^^^^^v^^^^^^^^^^%   vvv^^^^^^^^((##########   .
^^^^v^^^^^^^^^^^^^  ^^^^^^^^^^^^vvvvv^^^^^^^   ^^^^^^^^^^^vv^^^^^^^^^%%%%^^v^^^^^^^^^(###########  .
^^^^vv^^^^^^^^^^A  ^^^^^^^^^^^^^^v^^^^^^^^^^^^!  ^^^^^^^vvvv^^^^^^^^^^^^^^^vvvv^^^^^^((########### .
^^^^^v^^^^^^^^^^^ ^^^^^^^^^^^^^^^vv^^^^^^^^^^^^^   ^^^^^v^^v^^^^^^^^^^^^^^^^^^vvvv^^^((############.
^^^^^v^^^^^^^^^^^ ^^^^^^^^^^^^^^^^v^^^^^^^^^^^^^^v^^^^^^v^^vv^^^^^^^^^^^^^^^^^^^^vvvv((#############
^^^^^vv^^^^^^^^^^  ^^^^^^^^^^^^^^^vv^^^^^^^^^^^^^v^^^^^vv^^^vv^^^^^^^^^^^^^^^^^^^^^^^^(#############
^^^^^^v^^^^^^^^^^^ ^^^^^^^^^^^^^^^^v^^^^^^^^^^^^^vvv^^vv^^^^^v^^^^^^^^^^^^^^^^^^^^^^^^((############
^^^^^^vv^^^^^^^^^^!^^^^^^^^^^^^^^^^vv^^^^^^^^^^^^^^vvvv^^^^^^vv^^^^^^^^^^^^^^^^^^^^^^^((############
^^^^^^^v^^^^^^^^^^  ^^^^^^^^^^^^^^^^v^^^^^^^^^^^^^^^^^^^^^^^^^v^^^^^^^^^^^^^^^^^^^^^^^^((###########
^^^^^^^v^^^^^^^^^^^ ^^^^^^^^^^^^^^^^vv^^^^^^^^^^^^^^^^^^^^^^^^vv^^^^^^^^^^^^^^^^^^^^^^^^(###########
^^^^^^^vv^^^^^^^^^^ ^^^^^^^^^^^^^^^^^vv^^^^^^^^^^^^^^^^^^^^^^^^v^^^^^^^^^^^^^^^^^^^^^^^^((##########
^^^^^^^^vvvvv^^^^^^  ^^^^^^^^^^^^^^^^^vv^^^^^^^^^^^^^^^^^^^^^^^vv^^^^^^^^^^^^^^^^^^^^^^^((##########
^^^^^^^^v^^^vvvv^^^^ ^^^^^^^^^^^^^^^^^^vv^^^^^^^^^^^^^^^^^^^^^^^vv^^^^^^^^^^^^^^^^^^^^^^^((#########
^^^^^^^^vv^^^^^vvv^^v^^^^^^^^^^^^^^^^^^^v^^^^^^^^^^^^^^^^^^^^^^^^v^^^^^^^^^^^^^^^^^^^^^^^((#########
^^^^^^^^^vv^^^^^^vv^v^^^^^^^^^^^^^^^^^^^vv^^^^^^^^^^^^^^^^^^^^^^^vv^^^^^^^^^^^^^^^^^^^^^^^(#########
^^^^^^^^^^v^^^^^^^vvv^^^^^^^^^^^^^^^^^^^^v^^^^^^^^^^^^^^^^^^^^^^^^v^^^^^^^^^^^^^^^^^^^^^^^((########
^^^^^^^^^^v^^^^^^^^^^^^^^^^^^^^^^^^^^^^^^v^^^^^^^^^^^^^^^^^^^^^^^^v^^^^^^^^^^^^^^^^^^^^^^^((########
