      ^^^^^^^^^^^^^^^^^^^^^^^^^^^^^^^^^^^^^^^^^^^^^^^^^^^^^^^^^^^^^^^^^^^^^^^^^^^~~~~~~~~~~~~~~~~~~~
      ^^^^^^^^^^^^^^^^^^^^^^^^^^^^^^^^^^^^^^^^^^^^^^^^^^^^^^^^^^^^^^^^^^^^^^^^^^^~~~~~~~~~~~~~~~~~~~
       ^^^^^^^^^^^^^^^^^^^^^^^^^^^^^^^^^^^^^^^^^^^^^^^^^^^^^^^^^^^^^^^^^^^^^^^^^^^~~~~~~~~~~~~~~~~~~
       ^^^^^^^^^^^^^^^^^^^^^^^^^^^^^^^^^^^^^^^^^^^^^^^^^^^^^^^^^^^^^^^^^^^^^^^^^^^~~~~~~~~~~~~~~~~~~
       ^^^^^^^^^^^^^^^^^^^^^^^^^^^^^^^^^^^^^^^^^^^^^^^^^^^^^^^^^^^^^^^^^^^^^^^^^^^~~~~~~~~~~~~~~~~~~
        ^^^^^^^^^^^^^^^^^^^^^^^^^^^^^^^^^^^^^^^^^^^^^^^^^^^^^^^^^^^^^^^^^^^^^^^^^^^~~~~~~~~~~~~~~~~~
        ^^^^^^^^^^^^^^^^^^^^^^^^^^^^^^^^^^^^^^^^^^^^^^^^^^^^^^^^^^^^^^^^^^^^^^^^^^^~~~~~~~~~~~~~~~~~
        ^^^^^^^^^^^^^^^^^^^^^^^^^^^^^^^^^^^^^^^^^^^^^^^^^^^^^^^^^^^^^^^^^^^^^^^^^^^^~~~~~~~~~~~~~~~~
         ^^^^^^^^^^^^^^^^^^^^^^^^^^^^^^^^^^^^^^^^^^^^^^^^^^^^^^^^^^^^^^^^^^^^^^^^^^~~~~~~~~~~~~~~~~~
        ^^^^^^^^^^^^^^^^^^^^^^^^^^^^^^^^^^^^^^^^^^^^^^^^^^^^^^^^^^^^^^^^^^^^^^^^^^^^~~~~~~~~~~~~~~~~
       ^^^^^^^^^^^^^^^^^^^^^^^^^^^^^^^^^^^^^^^^^^^^^^^^^^^^^^^^^^^^^^^^^^^^^^^^^^^^~~~~~~~~~~~~~~~~~
       #^^^^^^^^^^^^^^^^^^^^^^^^^^^^^^^^^^^^^^^^^^^^^^^^^^^^^^^^^^^^^^^^^^^^^^^^^^^^~~~~~~~~~~~~~~~~
       #^^^^^^^^^^^^^^^^^^^^^^^^^^^^^^^^^^^^^^^^^^^^^^^^^^^^^^^^^^^^^^^^^^^^^^^^^^^^~~~~~~~~~~~~~~~~
       #^^^^^^^^^^^^^^^^^^^^^^^^^^^^^^^^^^^^^^^^^^^^^^^^^^^^^^^^^^^^^^^^^^^^^^^^^^^^^~~~~~~~~~~~~~~~
      ###^^^^^^^^^^^^^^^^^^^^^^^^^^^^^^^^^^^^^^^^^^^^^^^^^^^^^^^^^^^^^^^^^^^^^^^^^^^^~~~~~~~~~~~~~~~
     ####^^^^^^^^^^^^^^^^^^^^^^^^^^^^^^^^^^^^^^^^^^^^^^^^^^^^^^^^^^^^^^^^^^^^^^^^^^^^~~~~~~~~~~~~~~~
    #####^^^^^^^^^^^^^^^^^^^^^^^^^^^^^^^^^^^^^^^^^^^^^^^^^^^^^^^^^^^^^^^^^^^^^^^^^^^~~~~~~~~~~~~~~~~
  ########^^^^^^^^^^^^^^^^^^^^^^^^^^^^^^^^^^^^^^^^^^^^^^^^^^^^^^^^^^^^^^^^^^^^^^^^^^~~~~~~~~~~~~~~~~
#########^^^^^^^^^^^^^^^^^^^^^^^^^^^^^^^^^^^^^^^^^^^^^^^^^^^^^^^^^^^^^^^^^^^^^^^^^^^~~~~~~~~~~~~~~~~
#########^^^^^^^^^^^^^^^^^^^^^^^^^^^^^^^^^^^^^^^^^^^^^^^^^^^^^^^^^^^^^^^^^^^^^^^^^^~~~~~~~~~~~~~~~~~
#########^^^^^^^^^^^^^^^^^^^^^^^^^^^^^^^^^^^^^^^^^^^^^^^^^^^^^^^^^^^^^^^^^^^^^^^^^~~~~~~~~~~~~~~~~~~
#########^^^^^^^^^^^^^^^^^^^^^^^^^^^^^^^^^^^^^^^^^^^^^^^^^^^^^^^^^^^^^^^^^^^^^^^^~~~~~~~~~~~~~~~~~~~
##########^^^^^^^^^^^^^^^^^^^^^^^^^^^^^^^^^^^^^^^^^^^^^^^^^^^^^^^^^^^^^^^^^^^^^^^~~~~~~~~~~~~~~~~~~~
##########^^^^^^^^^^^^^^^^^^^^^^^^^^^^^^^^^^^^^^^^^^^^^^^^^^^^^^^^^^^^^^^^^^^^^^~~~~~~~~~~~~~~~~~~~~
##########^^^^^^^^^^^^^^^^^^^^^^^^^^^^^^^^^^^^^^^^^^^^^^^^^^^^^^^^^^^^^^^^^^^^^~~~~~~~~~~~~~~~~~~~~~
###########^^^^^^^^^^^^^^^^^^^^^^^^^^^^^^^^^^^^^^^^^^^^^^^^^^^^^^^^^^^^^^^^^^^~~~~~~~~~~~~~~~~~~~~~~
############^^^^^^^^^^^^^^^^^^^^^^^^^^^^^^^^^^^^^^^^^^^^^^^^^^^^^^^^^^^^^^^^^~~~~~~~~~~~~~~~~~~~~~~~
############^^^^^^^^^^^^^^^^^^^^^^^^^^^^^^^^^^^^^^^^^^^^^^^^^^^^^^^^^^^^^^^^~~~~~~~~~~~~~~~~~~~~~~~~
############^^^^^^^^^^^^^^^^^^^^^^^^^^^^^^^^^^^^^^^^^^^^^^^^^^^^^^^^^^^^^^^^^~~~~~~~~~~~~~~~~~~~~~~~
#############^^^^^^^^^^^^^^^^^^^^^^^^^^^^^^^^^^^^^^^^^^^^^^^^^^^^^^^^^^^^^^^~~~~~~~~~~~~~~~~~~~~~~~~
##############^^^^^^^^^^^^^^^^^^^^^^^^^^        ^^^^^^^^^^^^^^^^^^^^^^^^^^^^~~~~~~~~~~~~~~~~~~~~~~~~
###############^^^^^^^^^^^^^^^^^^^^^^^^           ^^^^^^^^^^^^^^^^^^^^^^^^^^^^~~~~~~~~~~~~~~~~~~~~~~
###############^^^^^^^^^^^^^^^^^^^^^^^             ^^^^^^^^^^^^^^^^^^^^^^^^^^^^~~~~~~~~~~~~~~~~~~~~~
##############^^^^^^^^^^^^^^^^^^^^^^^    ~~~~~~~    ^^^^^^^^^^^^^^^^^^^^^^^^^^^^~~~~~~~~~~~~~~~~~~~~
###############^^^^^^^^^^^^^^^^^^^^^   ~~~~~~~~~~~    ^^^^^^^^^^^^^^^^^^^^^^^^^^~~~~~~~~~~~~~~~~~~~~
###############^^^^^^^^^^^^^^^^^^^^   ~~~~~~~~~~~~~     ^^^^^^^^^^^^^^^^^^^^^^^^^~~~~~~~~~~~~~~~~~~~
~~~~~~~~~~~~~~~~~^^^^^^^^^^^^^^^^^   ~~~~~~~~~~~~~~~    ^^^^^^^^^^^^^^^^^^^^^^^^^^~~~~~~~~~~~~~~~~~~
~~~~~~~~~~~~~~~~~~~~~~~~~~~~~~^^^^   ~~~~~~~~~~~~~~~~    ^^^^^^^^^^^^^^^^^^^^^^^^^^^~~~~~~~~~~~~~~~~
################~~~~~~~~~~~~~~~~~~~~~~~~~~~~~~~~~~~~~~   ^^^^^^^^^^^^^^^^^^^^^^^^^^^^~~~~~~~~~~~~~~~
####################^^^^^^^^^~~~~~~~~~~~~~~~~~~~~~~~~~A  vvv^^^^^^^^^^^^^^^^^^^^^^^^^~~~~~~~~~~~~~~~
^^^^^^^^^^^^^^^^^^^^^^^^^^^^^^^^^^  ~~~~~~~~~~~~~~~~~~  ^^^vvv^^^^^^^^^^^^^^^^^^^^^^^~~~~~~~~~~~~~~~
^^^^^^^^^^^^^^^^^^^^^^^^^^^^^^^^^^   ~~~~~~~~~~~~~~~~   ^^^^^vv^^^^^^^^^^^^^^^^^^^^~~~~~~~~~~~~~~~~~
^^^^^^^^^^^^^^^^^^^^^^^^^^^^^^^^^^   ~~~~~~~~~~~~~~~   ^^^^^^^vv^^^^^^^^^^^^^^^^^^^^~~~~~~~~~~~~~~~~
^^^^^^^^^^^^^^^^^^^^^^^^^^^^^^^^^^^   ~~~~~~~~~~~~~   ^^^^^^^^^v^^^^^^^^^^^^^^^^^^^^~~~~~~~~~~~~~~~~
^^^^^^^^^^^^^^^^^^^^^^^^^^^^^^^^^^^^    ~~~~~~~~~   ^^^^^^^^^^^v^^^^^^^^^^^^^^^^^^^^^~~~~~~~~~~~~~~~
^^^^^^^^^^^^^^^^^^^^^^^^^^^^^^^^^^^^^               ^^^^^^^^^^^v^^^^^^^^^^^^^^^^^^^^~~~~~~~~~~~~~~~~
^^^^^^^^^^^^^^^^^^^^^^^^^^^^^^^^^^^^^^             ^^^^^^^^^^^vvv^^^^^^^^^^^^^^^^^~~~~~~~~~~~~~~~~~~
^^^^^^^^^^^^^^^^^^^^^^^^^^^^^^^^^^^^^^^^^^^^^^^^^^^^^^^^^^^^^^v^v^^^^^^^^^^^^^^^^^~~~~~~~~~~~~~~~~~~
^^^^^^^^^^^^^^^^^^^^^^^^^^^^^^^^^^^^^^^^^^^^^^^^^^^^^^^^^^^^^vv^v^^^^^^^^^^^^^^^^^^~~~~~~~~~~~~~~~~~
^^^^^^^^^^^^^^^^^^^^^^^^^^^^^^^^^^^^^^^^^^^^^^^^^^^^^^^^^^^^^v^^vv^^^^^^^^^^^^^^^^^^~~~~~~~~~~~~~~~~
^^^^^^^^^^^^^^^^^^^^^^^^^^^^^^^^^^^^^^^^^^^^^^^^^^^^^^^^^^^^vv^^^v^^^^^^^^^^^^^^^^^^~~~~~~~~~~~~~~~~
^^^^^^^^^^^^^^^^^^^^^^^^^^^^^^^^^^^^^^^^^^^^^^^^^^^^^^^^^vvvv^^^^v^^^^^^^^^^^^^^^^^^~~~~~~~~~~~~~~~~
^^^^^^^^^^^^^^^^^^^^^^^^^^^^^^^^^^^^^^^^^^^^^^^^^^^^vvvvvv^^^^^^^v^^^^^^^^^^^^^^^^^~~~~~~~~~~~~~~~~~
^^^^^^^^^^^^^^^^^^^^^^^^^^^^^^^^^^^^^^^^^^^^^^vvvvvvv^^^^^^^^^^^^vv^^^^^^^^^^^^^^^~~~~~~~~~~~~~~~~~~
^^^^^^^^^^^^^^^^^^^^^^^^^^^^^^^^^^^^vvvvvvvvvvv^^^^^^^^^^^^^^^^^^^v^^^^^^^^^^^^^^^~~~~~~~~~~~~~~~~~~
^^^^^^^^^^^^^^^^^^^^^^^^vvvvvvvvvvvvv^^^^^^^v^^^^^^^^^^^^^^^^^^^^^v^^^^^^^^^^^^^^~~~~~~~~~~~~~~~~~~~
^^^^^^^^^^^^vvvvvvvvvvvvv^^^^^^^^^^^^^^^^^^^v^^^^^^^^^^^^^^^^^^^^^v^^^^^^^^^^^^^~~~~~~~~~~~~~~~~~~~~
vvvvvvvvvvvvv^^^^^^^^^^^^^^^^^^^^^^^^^^^^^^^vvv^^^^^^^^^^^^^^^^^^^vv^^^^^^^^^^^^~~~~~~~~~~~~~~~~~~~~
^^^^^^^^v^^^^^^^^^^^^^^^^^^^^^^^^^^^^^^^^^^^^^vvv^^^^^^^^^^^^^^^^^^v^^^^^^^^^^^~~~~~~~~~~~~~~~~~~~~~
^^^^^^^^v^^^^^^^^^^^^^^^^^^^^^^^^^^^^^^^^^^^^^^^vv^^^^^^^^^^^^^^^^^v^^^^^^^^^^^~~~~~~~~~~~~~~~~~~~~~
^^^^^^^^vv^^^^^^^^^^^^^^^^^^^^^^^^^^^^^^^^^^^^^^^v^^^^^^^^^^^^^^^^^v^^^^^^^^^^~~~~~~~~~~~~~~~~~~~~~~
^^^^^^^^^vv^^^^^^^^^^^^^^^^^^^^^^^^^^^^^^^^^^^^^   ^^^^^^^^^^^^^^^vv^^^^^^^^^^~~~~~~~~~~~~~~~~~~~~~~
^^^^^^^^^^v^^^^^^^^^^^^^^^^^^^^^^^^^^^^^^^^^^^^      ^^^^^^^^^^^^^v^^^^^^^^^^^^~~~~~~~~~~~~~~~~~~~~~
^^^^^^^^^^v^^^^^^^^^^^^^^^^^^^^^^^^^^^^^^^^^^^^^    vvvv^^^^^^^^^^v^^^^^^^^^^^~~~~~~~~~~~~~~~~~~~~~~
^^^^^^^^^^vvvv^^^^^^^^^^^^^^^^^^^^^^^^^^^^^^^^^^^  ^^^^vv^^^^^^^^^v^^^^^^^^^^^~~~~~~~~~~~~~~~~~~~~~~
^^^^^^^^^^^^^vv^^   ^^^^^^^^^^^^^^^^^^^^^^^^^^^^^^A^^^^^v^^^^^^^^^v^^^^^^^^^^^^~~~~~~~~~~~~~~~~~~~~~
^^^^^^^^^^^^^^        ^^^^^^^^^^^^^^^^^^^^^^^^^^^^^^^^^^v^^^^^^^^vv^^^^^^^^^^^^~~~~~~~~~~~~~~~~~~~~~
^^^^^^^^^^^^^            ^^^^^^^^^^^^^^^^^^^^^^^^^^^^^^^vv^^^^^^^v^^^^^^^^^^^^^~~~~~~~~~~~~~~~~~~~~~
^^^^^^^^^^^^^^^^            vvv^^^^^^^^^^^^^^^^^^^^^^^^^^vvvv^^^^v^^^^^^^^^^^^^^~~~~~~~~~~~~~~~~~~~~
^^^^^^^^^^^^^^^^^^^       ^^^^vvvv^^^^^^^^^^^^^^^^^^^^^^^^^^v^vvvv^^^^^^^^^^^^^^~~~~~~~~~~~~~~~~~~~~
^^^^^^^^^^^^^^^^^^^A^^^^^^^^^^^^^vvvv^^^^^^^^^^^^^^^^^^^^^^vvvv^^v^^^^^^^^^^^^^^~~~~~~~~~~~~~~~~~~~~
^^^^^^^^^^^^^^^^^^^^^^^^^^^^^^^^^^^^vv^^^^^^^^^^^^^^^^^vvvvv^^^^^v^^^^^^^^^^^^^^^~~~~~~~~~~~~~~~~~~~
^^^^^^^^^^^^^^^^^^^^^^^^^^^^^^^^^^^^^v^^^^^^^^^^^^vvvvvv^^^^^^^^vv^^^^^^^^^^^^^^^^~~~~~~~~~~~~~~~~~~
^^^^^^^^^^^^^^^^^^^^^^^^^^^^^^^^^^^^^v^^^^^^^^vvvvv^^^^^^^^^^^^^v^^^^^^^^^^^^^^^^^~~~~~~~~~~~~~~~~~~
^^^^^^^^^^^^^^^^^^^^^^^^^^^^^^^^^^^vvvvvvvvvvvv^^^^^^^^^^^^^^^^^v^^^^^^^^^^^^^^^^^~~~~~~~~~~~~~~~~~~
^^^^^^^^^^^^^^^^^^^^^^vvvvvvvvvvvvvv^^^^^^^^^^^^^^^^^^^^^^^^^^^vv^^^^^^^^^^^^^^^^^^~~~~~~~~~~~~~~~~~
^^^^^^^^^^vvvvvvvvvvvvv^^^^^^^^^^^^^^^^^^^^^^^^^^^^^^^^^^^^^^^vv^^^^^^^^^^^^^^^^^^^~~~~~~~~~~~~~~~~~
vvvvvvvvvvv^^^^^^^^^^v^^^^^^^^^^^^^^^^^^^^^^^^^^^^^^^^^^^^^^^vv^^^^^^^^^^^^^^^^^^^^~~~~~~~~~~~~~~~~~
^^^^^^^^^^^^^^^^^^^^vv^^^^^^^^^^^^^^^^^^^^^^^^^^^^^^^^^^^^^^^v^^^^^^^^^^^^^^^^^^^^^^~~~~~~~~~~~~~~~~
^^^^^^^^^^^^^^^^^vvvv^^^^^^^^^^^^^^^^^^^^^^^^^^^^^^^^^^^^^^^vv^^^^^^^^^^^^^^^^^^^^^^~~~~~~~~~~~~~~~~
^^^^^^^^^^^^^^^^^v^^^^^^^^^^^^^^^^^^^^^^^^^^^^^^^^^^^^^^^^^vv^^^^^^^^^^^^^^^^^^^^^^~~~~~~~~~~~~~~~~~
^^^^^^^^^^^^^^^^    ^^^^^^^^^^^^^^^^^^^^^^^^^^^^^^^^^^^^vvvv^^^^^^^^^^^^^^^^^^^^^^^~~~~~~~~~~~~~~~~~
^^^^^^^^^^^^^^        ^^^^^^^^^^^^^^^^^^^^^^^^^^^^^^^^^vv^^^^^^^^^^^^^^^^^^^^^^^^^~~~~~~~~~~~~~~~~~~
^^^^^^^^^^^A        ^^^^^^^^^^^^^^^^^^^^^^^^^^^^^^^^vvvv^^^^^^^^^^^^^^^^^^^^^^^^^^~~~~~~~~~~~~~~~~~~
^^^^^^^^^^^^^^    ^v^^^^^^^^^^^^^^^^^^^^^^^^^^^^^^vvv^^^^^^^^^^^^^^^^^^^^^^^^^^^^^~~~~~~~~~~~~~~~~~~
^^^^^^^^^^^^^^^^^^^v^^^^^^^^^^^^^^^^^^^^^^^^^^^vvvv^^^^^^^^^^^^^^^^^^^^^^^^^^^^^^^~~~~~~~~~~~~~~~~~~
^^^^^^^^^^^^^^^^^^^vvv^^^^^^^^^^^^^^^^^^^^^vvvvv^^^^^^^^^^^^^^^^^^^^^^^^^^^^^^^^^~~~~~~~~~~~~~~~~~~~
^^^^^^^^^^^^^^^^^^^^^v^^^^^^^^^^^^^^^vvvvvvv^^^^^^^^^^^^^^^^^^^^^^^^^^^^^^^^^^^^^~~~~~~~~~~~~~~~~~~~
^^^^^^^^^^^^^^^^^^^^^v^^^^^vvvvvvvvvvv^^^^^^^^^^^^^^^^^^^^^^^^^^^^^^^^^^^^^^^^^^~~~~~~~~~~~~~~~~~~~~
^^^^^^^^^^^vvvvvvvvvvvvvvvvv^^^^^^^^^^^^^^^^^^^^^^^^^^^^^^^^^^^^^^^^^^^^^^^^^^^^~~~~~~~~~~~~~~~~~~~~
vvvvvvvvvvvv^^^^^^^^^^^^^^^^^^^^^^^^^^^^^^^^^^^^^^^^^^^^^^^^^^^^^^^^^^^^^^^^^^^^~~~~~~~~~~~~~~~~~~~~
^^^^^^^^^^^^^^^^^^^^^^^^^^^^^^^^^^^^^^^^^^^^^^^^^^^^^^^^^^^^^^^^^^^^^^^^^^^^^^^~~~~~~~~~~~~~~~~~~~~~
^^^^^^^^^^^^^^^^^^^^^^^^^^^^^^^^^^^^^^^^^^^^^^^^^^^^^^^^^^^^^^^^^^^^^^^^^^^^^^^~~~~~~~~~~~~~~~~~~~~~
^^^^^^^^^^^^^^^^^^^^^^^^^^^^^^^^^^^^^^^^^^^^^^^^^^^^^^^^^^^^^^^^^^^^^^^^^^^^^^^~~~~~~~~~~~~~~~~~~~~~
^^^^^^^^^^^^^^^^^^^^^^^^^^^^^^^^^^^^^^^^^^^^^^^^^^^^^^^^^^^^^^^^^^^^^^^^^^^^^^^~~~~~~~~~~~~~~~~~~~~~
^^^^^^^^^^^^^^^^^^^^^^^^^^^^^^^^^^^^^^^^^^^^^^^^^^^^^^^^^^^^^^^^^^^^^^^^^^^^^^^^~~~~~~~~~~~~~~~~~~~~
^^^^^^^^^^^^^^^^^^^^^^^^^^^^^^^^^^^^^^^^^^^^^^^^^^^^^^^^^^^^^^^^^^^^^^^^^^^^^^^^~~~~~~~~~~~~~~~~~~~~
^^^^^^^^^^^^^^^^^^^^^^^^^^^^^^^^^^^^^^^^^^^^^^^^^^^^^^^^^^^^^^^^^^^^^^^^^^^^^^^^~~~~~~~~~~~~~~~~~~~~
^^^^^^^^^^^^^^^^^^^^^^^^^^^^^^^^^^^^^^^^^^^^^^^^^^^^^^^^^^^^^^^^^^^^^^^^^^^^^^^^~~~~~~~~~~~~~~~~~~~~
^^^^^^^^^^^^^^^^^^^^^^^^^^^^^^^^^^^^^^^^^^^^^^^^^^^^^^^^^^^^^^^^^^^^^^^^^^^^^^^^~~~~~~~~~~~~~~~~~~~~
