^^^^^^^^^^v^^^^^^^^^^^^^^^^^^^^^^^^^^^^^^v^^^^^^^^^^^^^^^^^^^^^^^^v^^^^^^^^^^^^^^^^^^^^^^^((########
^^^^^^^^^^vv^^^^^^^^^^^^^^^^^^^^^^^^^^^^^v^^^^^^^^^^^^^^^^^^^^^^^^vv^^^^^^^^^^^^^^^^^^^^^^((########
^^^^^^^^^^^v^^^^^^^^^^^^^^^^^^^^^^^^^^^^^vvv^^^^^^^^^^^^^^^^^^^^^^^v^^^^^^^^^^^^^^^^^^^^^^^((#######
^^^^^^^^^^^v^^^^^^^^^^^^^^^^^^^^^^^^^^^^^^^v^^^^^^^^^^^^^^^^^^^^^^^vv^^^^^^^^^^^^^^^^^^^^^^^((######
^^^^^^^^^^^v^^^^^^^^^^^^^^^^^^^^^^^^^^^^^^^vv^^^^^^^^^^^^^^^^^^^^^^^v^^^^^^^^^^^^^^^^^^^^^^^((######
^^^^^^^^^^^vv^^^^^^^^^^^^^^^^^^^^^^^^^^^^^^^v^^^^^^^^^   ^^^^^^^^^^^vv^^^^^^^^^^^^^^^^^^^^^^^((#####
^^^^^^^^^^^^v^^^^^^^^^^^^^^^^^^^^^^^^^^^^^^^v^^^^^^^^^^   ^^^^^^^^^^^v^^^^^^^^^^^^^^^^^^^^^^^((#####
^^^^^^^^^^^^vv^^^^^^^^^^^^^^^^^^^^^^^^^^^^^^vvvvv^^^^^^^  ^^^^^^^^vvvv^^^^^^^^^^^^^^^^^^^^^^^((#####
^^^^^^^^^^^^^v^^^^^^^^^^^^~~^^^^^^^^^^^^^^^^v^^^vvv^^^vvv  ^^^^^^vv^^v^^^^^^^^^^^^^^^^^^^^^^^^(#####
^^^^^^^^^^^^^v^^^^^^^^^^^^!~~^^^^^^^^^^^^^^^vv^^^^v^^^v^^^  ^^^vvv^^^vv^^^^^^^^^^^^^^^^^^^^^^^((####
^^^^^^^^^^^^^v^^^^^^^^^^^^^ ~^^^^^^^^^^^^^^^^v^^^^v^^^vv^^^ vvvv^^^^^^v^^^^^^^^^^^^^^^^^^^^^^^^(####
^^^^^^^^^^^^^vv^^^^^^^^^^^^^  ^^^^^^^^^^^^^^^v^^^^vv^^^vv^^ ^^^^^^^^^^vv^^^^^^^^^^^^^^^^^^^^^^^((###
^^^^^^^^^^^^^^vvvvv^^^^^^^^^^  ^^^^^^^^^^^^^^vvv^^^v^^^^v^^ ^^^^^^^^^^^v^^^^^^^^^^^^^^^^^^^^^^^^(###
^^^^^^^^^^^^^^v^^^vvvv^^^^^^^^ ^^^^^^^^^^^^^^^^vv^^v^^^^v^^   ^^^^^^^^^vv^^^^^^^^^^^^^^^^^^^^^^^(###
^^^^^^^^^^^^^^vv^^^^^vvv^^^^^^ ^^^^^^^^^^^^^^^^^v^^vv^^^v^^^~  ^^^^^^^^^v^^^^^^^^^^^^^^^^^^^^^^^((##
^^^^^^^^^^^^^^^v^^^^^^^vv^^^^^ ^^^^^^^^^^^^^^^^^v^^^vv^^v^^^^~ ^^^^^^^^^vv^^^^^^^^^^^^^^^^^^^^^^^(##
^^^^^^^^^^^^^^^v^^^^^^^^v^^^^  ^^^^^^^^^^^^^^^^^v^^^^vvvv^^^^~!^^^^^^^^^^v^^^^^^^^^^^^^^^^^^^^^^^((#
^^^^^^^^^^^^^^^vv^^^^^^^v^^^  ^^^^^^^^^^^^^^^^^^v^^^^^^^^^^^^^^^^^^^^^^^^vv^^^^^^^^^^^^^^^^^^^^^^^(#
^^^^^^^^^^^^^^^^v^^^^^^^vv^^^ ^^^^^^^^^^^^^^^^^^v^^^^^^^^^^^^^^^^^^^^^^^^^v^^^^^^^^^^^^^^^^^^^^^^^((
^^^^^^^^^^^^^^^^vv^^^^^^^v^^^v^^^^^^^^^^^^^^^^^^v^^^^^^^^^^^^^^^^^^^^^^vvvv^^^^^^^^^^^^^^^^^^^^^^^^^
^^^^^^^^^^^^^^^^^v^^^^^^^v^^vv^^^^^^^^^^^^^^^^^^vv^^^^^^^^^^^^^^^^^^^^^v^^v^^^^^^^^^^^^^^^^^^^^^^^^^
^^^^^^^^^^^^^^^^^v^^^^^^^vvvv^^^^^^^^^^^^^^^^^^^^v^^^^^^^^^^^^^^^^^^^^^v^^vv^^^^^^^^^^^^^^^^^^^^^^^^
^^^^^^^^^^^^^^^^^vv^^^^^^^^^^^^^^^^^^^^^^^^^^^^^^v^^^^^^^^^^^^^^^^^^vvvv^^^vv^^^^^^^^^^^^^^^^^^^^^^^
^^^^^^^^^^^^^^^^^^v^^^^^^^^^^^^^^^^^^^^^^^^^^^^^^vv^^^^^^^^^^^^vvvvvv^^^^^^^v^^^^^^^^^^^^^^^^^^^^^^^
^^^^^^^^^^^^^^^^^^vv^^^^^^^^^^^^^^^^^^^^^^^^^^^^^^v^^^^^^^^^^^^v^^^^^^^^^^^^vv^^^^^^^^^^^^^^^^^^^^^^
^^^^^^^^^^^^^^^^^^^v^^^^^^^^^^^^^^^^^^^^^^^^^^^^^^vv^^^^^^^^^^^v^^^^^^^^^^^^^vv^^^^^^^^^^^^^^^^^^^^^
-^^^^^^^^^^^^^^^^^^v^^^^^^^^^^^^^^^^^^^^^^^^^^^vvvvv^^^^^^^^^^^v^^^^^^^^^^^^vvvv^^^^^^^^^^^^^^^^^^^^
---^^^^^^^^^^^^Avvvv^^^^^^^^^^^^  ^^^^^^^^^^^^^v^^^v^^^^^^^^^    ^^^^^^^^^^vv^^v^^^^^^^^^^^^^^^^^^^^
----^^^^^^^^^^^^^^v^^^^^^^^^^vvvv  ^^^^^^^^^^^^v^^^vv^^^^^^^^    ^^^^^^^^^vv^^^v^^^^^^^^^^^^^^^^^^^^
------^^^^^^^^^^^^v^^^^^^^^vvv^^^  ^^^^^^^^^^^^v^^^^v^^^^^^^    ^^^^^^^^^^v^^^^v^^^^^^^^^^^^^^^^^^^^
-------^^^^^^^^^^^vv^^^^^vvv^^^^^^  ^^^^^^^^^^vv^^^^v^^^^^^^^    ~~~~~~~   ^^^^v^^^^^^^^^^^^^^^^^^^^
---------^^^^^^^^^^v^^^vvv^^^^^^^^^  ^^^^^^^vvv^^^^^v^^^^^^^^^  ~~~^^^^~~ A^^^^vv^^^^^^^^^^^^^^^^^^^
---------^^^^^^^^^^vvvvv^^^^^^^^^^^^ ^^^^vvvv^^^^^^^vv^^^^vvvvv ~~~^^^^~~~ ^^^^^v^^^^^^^^^^^^^^^^^^^
----------^^^^^^^^^vv^^^^^^^^^^^^^^^ vvvvv^^^^^^^^^^^vvvvvv^^^^^ ~~~^^^^~~~^^^^^vv^^^^^^^^^^^^^^^^^^
----------^^^^^^^^^^v^^^^^^^^^^^^^^^ ^^^^^^^^^^^^^^^^v^^^^^^^^^^^~~~~^^^^^^^^^^^^v^^^^^^^^^^^^^^^^^^
----------^^^^^^^^^^vv^^^^^^^^^^^^^^^^^^^^^^^^^^^^^^^vv^^^^^^^^^^~~~^^^^^^^^^^^^^v^^^^^^^^^^^^^^^^^^
-----------^^^^^^^^^^v^^^^^^^^^^^^^^^^^^^^^^^^^^^^^^^^v^^^^^^^^^^^^^^^^^^^^^^^vvvv^^^^^^^^^^^^^^^^^^
------------^^^^^^^^^vvv^^^^^^^^^^^^^^^^^^^^^^^^^^^^^^v^^^^^^^^^^^^^^^^^^^^^^vv^^v^^^^^^^^^^^^^^^^^^
-------------^^^^^^^^^^vv^^^^^^^^^^^^^^^^^^^^^^^^^^^^^vv^^^^^^^^^^^^^^^^^^^^^v^^^v^^^^^^^^^^^^^^^^^^
--------------^^^^^^^^^^v^^^^^^^^^^^^^^^^^^^^^^^^^^^^^^v^^^^^^^^^^^^^^^^^^^^^v^^^v^^^^^^^^^^^^^^^^^^
--------------^^^^^^^^Avvv^^^^^^^^^^^^^^^^^^^^^^^^^^^^^v^^^^^^^^^^^^^^^^^^^vvv^^^vv^^^^^^^^^^^^^^^^^
---------------^^^^^^^^^^v^^^^^^^^^^^^^^^^^^^^^^^^^^^^^v^^^^^^^^^^^^^^^^vvvv^^^^^^v^^^^^^^^^^^^^^^^^
---------------^^^^^^^^^^vv^^^^^^^^^^^^^^^^^^^^^^^^^^^^vv^^^^^^^^^^^^^^vv^^^^^^^^^v^^^^^^^^^^^^^^^^^
----------------^^^^^^^^^^v^^^^^^^^^^^^^^^^^^^^^^^^^^^^^v^^^^^^^^^^^^^vv^^^^^^^^^^vv^^^^^^^^^^^^^^^^
----------------^^^^^^^^^^v^^^^^^^^^^^^^^^^^^^^^^^^^^^^^v^^^^^^^^^^^^^v^^^^^^^^^^^^v^^^^^^^^^^^^^^^^
-----------------^^^^^^^^^vv^^^^^^^^^^^^^^^^^^^^^^^^^^^^vv^^^^^^^^^^^^A^^^^^^^^^^^^vv^^^^^^^^^^^^^^^
------------------^^^^^^^^^vvvvvvvv^^^^^^^^^^^^^^^^^^^^^^v^^^^^^^^^^^^^^^^^^^^^vvvvvv^^^^^^^^^^^^^^^
------------------^^^^^^^^^^v^^^^^vvvvvvvv^^^^^^^^^^^^^^^vv^^^^^^^^^^^^^^^^^^^^v^^^^v^^^^^^^^^^^^^^^
------------------^^^^^^^^^^vv^^^^^^^^^^^v^^^^^^^^^^^^^^^^v^^^^^^^^^^^^^  ^^^^^v^^^^v^^^^^^^^^^^^^^^
-----------------^^^^^^^^^^^^v^^^^^^^^^^^v  ^^^^^^^^^^^^^^vvvvvvv^^^^^^^    vvvv^^^^v^^^^^^^^^^^^^^^
----------------^^^^^^^^^^^^^vv^^^^^^^^^^^    ^^^^^^^^^^^^v^^^^^vvv^^^^^^   ^^^^^^^^vv^^^^^^^^^^^^^^
-----------------^^^^^^^^^^^^^vv^^^^^^^^^^^^   ^^^^^^^^^^^vv^^^^^^vvv^^^^^    ^^^^^^^v^^^^^^^^^^^^^^
-------------------^^^^^^^^^^^^vv^^^^^^^^^^^   ^^^^^^^^^^^^v^^^^^^^^vv^^^^^  ^^^^^^^^v^^^^^^^^^^^^^^
------------------^^^^^^^^^^^^^^v^^^^^^^^^^^  ^^^^^^^^^^vvvvv^^^^^^^^vv^^^^^  ^^^^^^^v^^^^^^^^^^^^^^
-------------------^^^^^^^^^^^^^v^^^^^^^^^^^^ ^^^^^^^vvvv^^^v^^^^^^^^^v^^^^^^ ^^^^^^^v^^^^^^^^^^^^^^
---------------------^^^^^^^^^^^vv^^^^^^^^^^^  vvvvvvv^^^^^^vvvvvvv^^^vvvv^^^ ^^^^^^^vv^^^^^^^^^^^^^
---------------------^^^^^^^^^^^^v^^^^^^^^^^^^ ^^^^^^^^^^^^^^v^^^^v^^^^^^vvvvv^^^^^^^^v^^^^^^^^^^^^^
--------------------^^^^^^^^^^^^^vv^^^^^^^^^^^^^^^^^^^^^^^^^^v^^^^vvv^^^^^^^^^^^^^^^^^v^^^^^^^^^^^^^
---------------------^^^^^^^^^^^^^v^^^^^^^^^^^^^^^^^^^^^^^^^^v^^^^^^vvv^^^^^^^^^^^^^^^v^^^^^^^^^^^^^
----------------------^^^^^^^^^^^^vv^^^^^^^^^^^^^^^^^^^^^^^^^v^^^^^^^^v^^^^^^^^^^^^^^^v^^^^^^^^^^^^^
-----------------------^^^^^^^^^^^^v^^^^^^^^^^^^^^^^^^^^^^^^^vvv^^^^^^v^^^^^^^^^^^^^^^v^^^^^^^^^^^^^
-------------------------A^^^^^^^^^v^^^^^^^^^^^^^^^^^^^^^^^^^^^v^^^^^^vvv^^^^^^^^^^^^^v^^^^^^^^^^^^^
-----------------------^^^^^^^^^^^^vv^^^^^^^^^^^^^^^^^^^^^^^^^^vv^^^^^^^vvvvv^^^^^^^^^v^^^^^^^^^^^^^
---------------------^^^^^^^^^^^^^^^v^^^^^^^^^^^^^^^^^^^^^^^^^^^v^^^^^^^^^^^v^^^^^^^^^vv^^^^^^^^^^^^
-------------------^^^^^^^^^^^^^^^^^vv^^^^^^^^^^^^^^^^^^^^^^^^^^vvv^^^^^^^^^vv^^^^^^^^^vv^^^^^^^^^^^
---------------------^^^^^^^^^^^^^^^^v^^^^^^^^^^^^^^^^^^^^^^^^^^^^v^^^^^^^^^^v^^^^^^^^^^v^^^^^^^^^^^
------------------------^^^^^^^^^^^^^v^^^^^^^^^^^^^^^^^^^^^^^^^^^^vv^^^^^^^^^v^^^^^^^^^^v^^^^^^^^^^^
---------------------------^^^^^^^^^^vv^^^^^^^^^^^  ^^^^^^^^^^^^^^^v^^^^^^^^^A^^^^^^^^^^v^^^^^^^^^^^
------------------------------^^^^^^^^v^^^^^^^^^^^^   ^^^^^^^^^^^^^vv^^^^^^^^^^^^^^^^^^^v^^^^^^^^^^^
-------------------------------^^^^^^^vv^^^^^^vvvv^^^ ^^^^^^^^^^^^^^v^^^^^vvvvv^^^^^^^^^v^^^^^^^^^^^
-------------------------------^^^^^^^^vvvvvvvv^^vvvv ^^^^^^^^^^^vvvvv^^^vv^^^     ^^^^^vv^^^^^^^^^^
--------------------------------^^^^^^^vv^^^^^^^^^^^  ^^^^^^^^^vvv^^^vv^^v^^^ ~~~~~ ^^^^^vv^^^^^^^^^
---------------------------------^^^^^^^vv^^^^^^^^^    ^^^^^^^^v^^^^^^vv^v^^ ~~~~~~~ ^^^^^v^^^^^^^^^
--------------------------------^^^^^^^^^v^^^^^^^^^^^   ^^^^^vvv^^^^^^^vvv^^ ~~~~~~~ ^^vvvv^^^^^^^^^
------------------------------^^^^^^^^^^^vv^^^^^^^^^^^^ !vvvvv^^^^^^^^^vv^^^  ~~~~~ vvvv^^v^^^^^^^^^
----------------------------((^^^^^^^^^^^^v^^^^^^^^^^^^^ ^^^^^^^^^^^^^^^v^^^^ !~~~ ^^^^^^^vv^^^^^^^^
----------------------------(((^^^^^^^^^^^vv^^^^^^^^^^^^ ^^^^^^^^^^^^^^^vv^^^^^^^^^^^^^^^^^v^^^^^^^^
--------------------------((((((^^^^^^^^^^^vvvvvvvvv^^^^^^^^^^^^^^^^^^^^^v^^^^^^^^^^^^^^^^^v^^^^^^^^
--------------------------((((((^^^^^^^^^^^v^^^^^^^vvvvvv^^^^^^^^^^^^^^^^v^^^^^^^^^^^^^^^^^v^^^^^^^^
-------------------------(((((((^^^^^^^^^^^vv^^^^^^^^^^^vvvv^^^^^^^^^^^^^vvv^^^^^^^^^^^^^^^^^^^^^^^^
------------------------((((((((A^^^^^^^^^^^vv^^^^^^^^^^^^^vvv^^^^^^^^^^^^^vv^^^^^^^^^^^^^^^^^^^^^^^
----------------------(((((((((((^^^^^^^^^^^^v^^^^^^^^^^^^^^^vv^^^^^^^^^^^^^v^^^^^^^^^^^^^^^^^^^^^^^
----------------------((((((((((((^^^^^^^^^^^vv^^^^^^^^^^^^^^^v^^^^^^^^^^^Avv^^^^^^vvvvvvv^^^^^^^^^^
--------------------(((((((((((((((^^^^^^^^^^^v^^^^^^^^^^^^^^^v^^^^^^^^^^^^^vvvv^^^v^^^^^vv^^^^^^^^^
-----------------(((((((((((((((((((^^^^^^^^^^vv^^^^^^^^^^^^^^  ^^^^^^^^^^^^^^^vvvvvv^^^^^vv^^^^^^^^
---------------(((((((((((((((((((((((^^^^^^^^^vv^^^^^^^^^^^^^^   ^^^^^^^^^^^^^^^^^^vvvv^^^vv^^^^^^^
--------------((((((((((((((((((((((((((^^^^^^^^v^^^^^^^^^^^^^^^    ^^^^^^^^^^^^^^^^^^^vv^^^!^^^^^^^
------------(((((((((((((((((((((((((((((^^^^^^^v^^^^^^^^^^^^^^^^^  ^^^^^^^^^^^^^^^^^^^^v^^^^^^^^^^^
-----------(((((((((((((((((((((((((((((((^^^^^^vv^^^^^^^^^^^^^^^^^  ^^^^^^^^^^^^^^^^^^^vv^^^^^^^^^^
-----------((((((((((((((((((((((((((((((((^^^^^^v^^^^^^^^^^^^^^^^^^  vvvvvvvvvvv^^^^^^^^v^^^^^^^^^^
----------((((((((((((((((((((((((((((^^^^^^^^^^^v^^^^^^^^^^^^^^^^^^^ ^^^^^^^^^^vvvvvvvvvvv^^^^^^^^^
----------((((((((((((((((((((((            ^^^^^vv^^^^^^^^^^^^^^^^^^  ^^^^^^^^^^^^^^^^^^^v^^^^^^^^^
-------^^^^^^                                  ^^^v^^^^^^^^^^^^^^^^^^^   ^^^^^^^^^^^^^^^^^vv^^^^^^^^
----^^^^^^^^^^^                                   !^^^^^^^^^^^^^^^^^^^^^  ^^^^^^^^^^^^^^^^^v^^^^^^^^
-^^^^^^^^^^^^^^^^!                ~~~!                ^^^^^^^^^^^^^^^^^^^! ^^^^^^^^^^^^^^^^v^^^^^^^^
^^^^^^^^^^^^^^^^^^^              ~~~~~~                ^^^^^^^^^^^^^^^^^^^^^^^^^^^^^^^^^^^^vv^^^^^^^
^^^^^^^^^^^^^^^^^^^^            ~~~~~~~~               ^^^^^^^^^^^^^^^^^^^^^^^^^^^^^^^^^^^^^v^^^^^^^
^^^^^^^^^^^^^^^^^^^^^           !~~~~~~~                ^^^^^^^^^^^^^^^^^^^^^^^^^^^^^^^^^^^^A^^^^^^^
^^^^^^^^^^^^^^^^^^^^^^                                    ^^^^^^^^^^^^^^^^^^^^^^^^^^^^^^^^^^v^^^^^^^
^^^^^^^^^^^^^^^^^^^^^^^                                    ^^^^^^^^^^^^^^^^^^^^^^^^^^^^^^^^^v^^^^^^^
