~~~~~~~~~^^^^^^^^^^^^^^^^^^^^^^^^----------------+----------------^^^^^^^^^^^^^^^^^^^^^^^^^^^^^^^^^^
~~~~~~~~~~^^^^^^^^^^^^^^^^^^^^^^^^---------------+-----------------^^^^^^^^^^^^^^^^^^^^^^^^^^^^^^^^^
~~~~~~~~~~~^^^^^^^^^^^^^^^^^^^^^^^^--------------+------------------^^^^^^^^^^^^^^^^^^^^^^^^^^^^^^^^
~~~~~~~~~~~~^^^^^^^^^^^^^^^^^^^^^^^--------------+------------------^^^^^^^^^^^^^^^^^^^^^^^^^^^^^^^^
~~~~~~~~~~~~~^^^^^^^^^^^^^^^^^^^^^---------------+-------------------^^^^^^^^^^^^^^^^^^^^^^^^^^^^^^^
~~~~~~~~~~~~^^^^^^^^^^^^^^^^^^^^^^^-------------++--------------------^^^^^^^^^^^^^^^^^^^^^^^^^^^^^^
~~~~~~~~~~~^^^^^^^^^^^^^^^^^^^^^^^^-------------+----------------------^^^^^^^^^^^^^^^^^^^^^^^^^^^^^
~~~~~~~~~~^^^^^^^^^^^^^^^^^^^^^^^^^^------------+------------------------^^^^^^^^^^^^^^^^^^^^^^^^^^^
~~~~~~~~~~^^^^^^^^^^^^^^^^^^^^^^^^^^^-----------+-------------------------^^^^^^^^^^^^^^^^^^^^^^^^^^
~~~~~~~~~~~^^^^^^^^^^^^^^^^^^^^^^^^^------------+--######-------------------^^^^^^^^^^^^^^^^^^^^^^^^
~~~~~~~~~~^^^^^^^^^^^^^^^^^^^^^^^^^^------------+-##!~~~##-------------------^^^^^^^^^^^^^^^^^^^^^^^
~~~~~~~~~^^^^^^^^^^^^^^^^^^^^^^^^^^-------------+###~~~~~##---------------------^^^^^^^^^^^^^^^^^^^^
~~~~~~~~^^^^^^^^^^^^^^^^^^^^^^^^^^^------------++-####~~~#------------------------^^^^^^^^^^^^^^^^^^
~~~~~~~~~^^^^^^^^^^^^^^^^^^^^^^^^^------------++-----#####--------------------------^^^^^^^^^^^^^^^^
~~~~~~~~~~^^^^^^^^^^^^^^^^^^^^^^^------------++--------------------------------------^^^^^^^^^^^^^^^
~~~~~~~~~~~^^^^^^^^^^^^^^^^^^^^^^-----------++-----------------------------------------^^^^^^^^^^^^^
~~~~~~~~~~~~^^^^^^^^^^^^^^^^^^^^-----------++-------------------------------------------^^^^^^^^^^^^
~~~~~~~~~~~~~^^^^^^^^^^^^^^^^^^^----------++---------------------------------------------^^^^^^^^^^^
~~~~~~~~~~~~^^^^^^^^^^^^^^^^^^^----------++------------------------------------------------^^^^^^^^^
~~~~~~~~~~~^^^^^^^^^^^^^^^^^^^----------++--------------------------------------------------^^^^^^^^
~~~~~~~~~~^^^^^^^^^^^^^^^^^^^^^--------++----------------------------------------------------^^^^^^^
~~~~~~~~~~^^^^^^^^^^^^^^^^^^^^^-------++-------------------------------------------------------^^^^^
~~~~~~~~~~^^^^^^^^^^^^^^^^^^^^^^-----++---------------------------------------------------------^^^^
~~~~~~~~~~~^^^^^^^^^^^^^^^^^^^^^^(--++---------------------^^-----------------------------------^^^^
~~~~~~~~~~~~~^^^^^^^^^^^^^^^^^^^^^(++-----------------------^^^-----------------------------------^^
~~~~~~~~~~~~^^^^^^^^^^^^^^^^^^^^^^(+-------------------------^^^^----------------------------------^
~~~~~~~~~~~^^^^^^^^^^^^^^^^^^^^^^(-+--------------------------^^^^----------------------------------
~~~~~~~~~~~^^^^^^^^^^^^^^^^^^^^^1+++++--------------------------^^^---------------------------------
~~~~~~~~~~^^^^^^^^^^^^^^^^^^^^^((----+++++-----------------------^^^--------------------------------
~~~~~~~~~~~^^^^^^^^^^^^^^^^^^A(----------++++---------------------^^--------------------------------
~~~~~~~~~~~~^^^^^^^^^^^^^^^^(---------------++++-------------------^--------------------------------
~~~~~~~~~~~~^^^^^^^^^^^^^^^--------------------++++-------------------------------------------------
~~~~~~~~~~~^^^^^^^^^^^^^^-------------------------++++----------------------------------------------
~~~~~~~~~~~~^^^^^^^^^^^^^^---------------------------++++-------------------------------------------
~~~~~~~~~~~~~^^^^^^^^^^^^^------------------------------+++-----------------------------------------
~~~~~~~~~~~~^^^^^^^^^^^^----------------------------------+++---------------------------------------
~~~~~~~~~~~^^^^^^^^^^^^-------------------------------------++--------------------------------------
~~~~~~~~~~~~^^^^^^^^^^^^^-------------------^^^^^^^----------++-------------------------------------
~~~~~~~~~~~~^^^^^^^^^^^^^^----------------^^^^^A^^^^^^--------++------------------------------------
~~~~~~~~~~~~^^^^^^^^^^^^^^^------------^^^^^^-------^^^^^------+------------------------------------
~~~~~~~~~~~~~^^^^^^^^^^^^^^-----------^^---------------^^------++-----------------------------------
~~~~~~~~~~~~~^^^^^^^^^^^^^--------------------------------------++----------------------------------
~~~~~~~~~~~~^^^^^^^^^^^^^^^--------------------------------------+----------------------------------
~~~~~~~~~~~^^^^^^^^^^^^^^^^^-------------------------------------+----------------------------------
~~~~~~~~~~^^^^^^^^^^^^^^^^^^-------------------------------------+----------------------------------
~~~~~~~~~~~~^^^^^^^^^^^^^^^^^------------------------------------+----------------------------------
~~~~~~~~~~~~^^^^^^^^^^^^^^^^^------------------------------------+-###------------------------------
~~~~~~~~~~~^^^^^^^^^^^^^^^^^-------------------------------------+-#~##-----------------------------
~~~~~~~~~~^^^^^^^^^^^^^^^^^--------------------------------------+##~~##----------------------------
~~~~~~~~~~~^^^^^^^^^^^^^^----------------------------------------+-#!##-----------------------------
~~~~~~~~~~~~^^^^^^^^^^^^----------------------------------------++-###------------------------------
~~~~~~~~~~~~^^^^^^^^^^^^^--------------------------------------++-----------------------------------
~~~~~~~~~~~^^^^^^^^^^^^^^-------------------------------------++------------------------------------
~~~~~~~~~~^^^^^^^^^^^^^^^^------------------------------------+-------------------------------------
~~~~~~~~~~~^^^^^^^^^^^^^^^------------------------------------+-------------------------------------
~~~~~~~~~~~^^^^^^^^^^^^^^------------------------------------++-------------------------------------
~~~~~~~~~~^^^^^^^^^^^^^^-------------------------------------+--------------------------------------
~~~~~~~~~^^^^^^^^^^^^^^--------------------------------------+--------------------------------------
~~~~~~~^^^^^^^^^^^^^^^^^^-----------------------------------++--------------------------------------
~~~~~~^^^^^^^^^^^^^^^^^^^^----------------------------------+---------------------------------------
~~~~~~~^^^^^^^^^^^^^^^^^^^^---------------------------------+---------------------------------------
~~~~~~~~~~^^^^^^^^^^^^^^^^^--------------------------------++---------------------------------------
~~~~~~~~~~~~^^^^^^^^^^^^^^^^-------------------------------+----------------------------------------
~~~~~~~~~~~~~~^^^^^^^^^^^^^^-------------------------------+----------------------------------------
~~~~~~~~~~~~~~^^^^^^^^^^^^^^^-------------------------####-+----------------------------------------
~~~~~~~~~~~~^^^^^^^^^^^^^^^^^^-----------------------##~!##+----------------------------------------
~~~~~~~~~^^^^^^^^^^^^^^^^^^^^^----------------------##~~##-+----------------------------------------
~~~~~~~~~^^^^^^^^^^^^^^^^^^^^^^--------------------##~~~#--+----------------------------------------
~~~~~~~~~~^^^^^^^^^^^^^^^^^^^^^^--------------------#~~##--++---------------------------------------
~~~~~~~~~~^^^^^^^^^^^^^^^^^^^^^^^-------------------####----++--------------------------------------
~~~~~~~~~~~^^^^^^^^^^^^^^^^^^^^^^----------------------------++-------------------------------------
~~~~~~~~~~~~^^^^^^^^^^^^^^^^^^^^(-----------------------------+-------------------------------------
~~~~~~~~~~~~~^^^^^^^^^^^^^^^^^((------------------------------+-------------------------------------
~~~~~~~~~~~~~~^^^^^^^^^^^^^^((((------------------------------+-------------------------------------
~~~~~~~~~~~~~~~^^^^^^^^^^^(((((((-----------------------------++------------------------------------
~~~~~~~~~~~~~~^^^^^^^^^^^((((^^^^(-----------------------------++-----------------------------------
~~~~~~~~~~~~~~^^^^^^^^^^~  ^^^^^^^^-----------------------------++----------------------------------
~~~~~~~~~~~~^^^^^^^^^^^~ ^^^^^^^^^^^-----------------------------++---------------------------------
~~~~~~~~~~~^^^^^^^^^^^~~ ^^^^^^^^^^^^-----------------------------++--------------------------------
~~~~~~~~~~~^^^^^^^^^^^^^A^^^^^^^^^^^-------------------------------++-------------------------------
~~~~~~~~~~~~^^^^^^^^^^^^^^^^^^^^^-----------------------------------++------------------------------
~~~~~~~~~~~^^^^^^^^^^^^^^^^^^^---------------------------------------++-####------------------------
~~~~~~~~~~~^^^^^^^^^^^^^^^^-------------------------------------------+##~!#------------------------
~~~~~~~~~~^^^^^^^^^^^^^^^---------------------------------------------+#~~~#------------------------
~~~~~~~~^^^^^^^^^^^^^^^^^---------------------------------------------+##~~##-----------------------
~~~~~~~^^^^^^^^^^^^^^^^^----------------------------------------------+-####------------------------
~~~~~~~~^^^^^^^^^^^^^^^^----------------------(((---------------------+-----------------------------
~~~~~~~~^^^^^^^^^^^^^^^^----------------------(A(---------------------+-----------------------------
~~~~~~~~~^^^^^^^^^^^^^^^^---------------------(((---------------------++----------------------------
~~~~~~~~~~^^^^^^^^^^^^^^^----------------------------------------------++---------------------------
~~~~~~~~~~~^^^^^^^^^^^^^^-----------------------------------------------+---------------------------
~~~~~~~~~~^^^^^^^^^^^^^^^-----------------------------------------------+---------------------------
~~~~~~~~~~~^^^^^^^^^^^^^^^----------------------------------------------+---------------------------
~~~~~~~~~~~^^^^^^^^^^^^^^^^^--------------------------------------------+---------------------------
~~~~~~~~~^^^^^^^^^^^^^^^^^^^^^^-----------------------------------------+--------------------------^
~~~~~~~~~~^^^^^^^^^^^^^^^^^^^^^^^^^^^^^^--------------------------------+-------------------------^^
~~~~~~~~~~~^^^^^^^^^^^^^^^^^^^^^^^^^^^^^^^^^^^^^^^^^^^^-----------------+------------------------^^^
~~~~~~~~~~~~^^^^^^^^^^^^^^^^^^^^^^^^^^^^^^^^^^^^^^^^^^^^^^^^^^^^^^^^^^^^+^^^^^^^^^^^^^^^^^^^^^^^^^^^
~~~~~~~~~~~~^^^^^^^^^^^^^^^^^^^^^^^^^^^^^^^^^^^^^^^^^^^^^^^^^^^^^^^^^^^^++^^^^^^^^^^^^^^^^^^^^^^^^^^
~~~~~~~~~~^^^^^^^^^^^^^^^^^^^^^^^^^^^^^^^^^^^^^^^^^^^^^^^^^^^^^^^^^^^^^^^+^^^^^^^^^^^^^^^^^^^^^^^^^^
