#############                      +~~~~~~~~~~~~~~~~~~~~~~~~~~~~~~~~~~~~~~~~~~~~~~~~~~~            .
#############                      +~~~~~~~~~~~~~~~~~~~~~~~~~~~~~~~~~~~~~~~~~~~~~~~~~~~            .
#############                     ++~~~~~~~~~~~~~~~~~~~~~~~~~~~~~~~~~~~~~~~~~~~~~~~~~~             .
#############                     +~~~~~~~~~~~~~~~~~~~~~~~~~~~~~~~~~~~~~~~~~~~~~~~~~~~             .
##############              !     +~~~~~~~~~~~~~~~~~~~~~~~~~~~~~~~~~~~~~~~~~~~~~~~~~~~             .
##############                   ++~~~~~~~~~~~~~~~~~~~~~~~~~~~~~~~~~~~~~~~~~~~~~~~~~~~             .
##############                !  +~~~~~~~~~~~~~~~~~~~~~~~~~~~~~~~~~~~~~~~~~~~~~~~~~~~              .
##############                   +~~~~~~~~~~~~~~~~~~~~~~~~~~~~~~~~~~~~~~~~~~~~~~~~~~~              .
###############           !      +~~~~~~~~~~~~~~~~~~~~~~~~~~~~~~~~~~~~~~~~~~~~~~~~~~~              .
###############                  +~~~~~~~~~~~~~~~~~~~~~~~~~~~~~~~~~~~~~~~~~~~~~~~~~~               .
###############       !      !  ++~~~~~~~~~~~~~~~~~~~~~~~~~~~~~~~~~~~~~~~~~~~~~~~~~~               .
##############           !      +~~~~~~~~~~~~~~~~~~~~~~~~~~~~~~~~~~~~~~~~~~~~~~~~~~~               .
#############                   +~~~~~~~~~~~~~~~~~~~~~~~~~~~~~~~~~~~~~~~~~~~~~~~~~~                .
############          !       ! +~~~~~~~~~~~~~~~~~~~~~~~~~~~  ~~~~~~~~~~~~~~~~~~~~~                .
############            !  !    +~~~~~~~~~~~~~~~~~~~~~~~~     ~~~~~~~~~~~~~~~~~~~~~                .
###########         !          ++~~~~~~~~~~~~~~~~~~~~~~~  !  ~~~~~~~~~~~~~~~~~~~~~~                .
###########           !      ! +~~~~~~~~~~~~~~~~~~~~~~      ~~~~~~~~~~~~~~~~~~~~~~                 .
###########       !       !    +~~~~~~~~~~~~~~~~~~~~~~      ~~~~~~~~~~~~~~~~~~~~~                  .
((#########          !         1~~~~~~~~~~~~~~~~~~~~~~      ~~~~~~~~~~~~~~~~~~~~~                  #
^(#########             !   !   ~~~~~~~~~~~~~~~~~~~~~ !    ~~~~~~~~~~~~~~~~~~~~~                  ##
^((########        !          ! ~~~~~~~~~~~~~~~~~~~~~      ~~~~~~~~~~~~~~~~~~~~~                  ##
^^(#########          !   !      ~~~~~~~~~~~~~~~~~~~~      ~~~~~~~~~~~~~~~~~~~~~                 ###
^^((########                !    ~~~~~~~~~~~~~~~~~~~        ~~~~~~~~~~~~~~~~~~~                  ###
^^^(########        !   !      !  ~~~~~~~~~~~~~~~~~~  ##  !  ~~~~~~~~~~~~~~~~~~                 ####
^^^((########             !  !    ~~~~~~~~~~~~~~~~~   ###      ~~~~~~~~~~~~~~~~                 ####
^^^^(########                   !  ~~~~~~~~~~~~~~~~ ! #####      ~~~~~~~~~~~~~                 #####
^^^^(#########                     ~~~~~~~~~~~~~~~~  #######   !     ~~~~~                     #####
^^^^((##########        !          ~~~~~~~~~~~~~~~   ########       !                         ######
^^^^^(##########            !      ~~~~~~~~~~~~~~~   ##########                               ######
^^^^^(############              !   ~~~~~~~~~~~~~    ############                            #######
^^^^^((#############                ~~~~~~~~~~~~~ ! #################                       ########
^^^^^^(################       !   !  ~~~~~~~~~~~~   ######################                ##########
^^^^^^(###################            ~~~~~~~~~~    ###############################     ############
^^^^^^((#####################        !  ~~~~~~~~   #################################################
^^^^^^^(########################        !  ~~~~ !  #################################################
^^^^^^^(###########################       ~~~~     #################################################
^^^^^^^((#############################    ~~~~    ##################################################
^^^^^^^((################################~~~~##################################################~~~~~
^^^^^^^((################################~~~~########################################~~~~~~~~~~~~~~~
^^^^^^^((###############################~~~~############################~~~~~~~~~~~~~~~~~~~~~~~~~###
^^^^^^^(((##############################~~~~##############~~~~~~~~~~~~~~~~~~~~~~~~~~~~~#############
^^^^^^^^((#############################~~~~~~~~~~~~~~~~~~~~~~~~~~~~~~~~~~~#######################^^^
^^^^^^^^((#############################~~~~~~~~~~~~~~~~~~~~~###########################^^^^^^^^^^^^^
^^^^^^^^((#############################~~~~###############################^^^^^^^^^^^^^^^^^^^^^^^^^^
^^^^^^^^((############################~~~~##################^^^^^^^^^^^^^^^^^^^^^^^^^^^^^^^^^^^^^^^^
^^^^^^^^(((###########################~~~~##^^^^^^^^^^^^^^^^^^^^^^^^^^^^^^^^^^^^^^^^^^^^^^^^^^^^^^^^
^^^^^^^^^(((((#######################~~~~##^^^^^^^^^^^^^^^^^^^^^^^^^^^^^^^^^^^^^^^^^^^^^^^^^^^^^^^^^
^^^^^^^^^(((((((#####################~~~~##^^^^^^^^^^^^^^^^^^^^^^^^^^^^^^^^^^^^^^^^^^^^^^^^^^^^^^^^^
^^^^^^^^^((((((((###################~~~~##^^^^^^^^^^^^^^^^^^^^^^^^^^^^^^^^^^^^^^^^^^^^^^^^^^^^^^^^^^
^^^^^^^^^A(((((((###################~~~~##^^^^^^^^^^^^^^^^^^^^^^^^^^^^^^^^^^^^^^^^^^^^^^^^^^^^^^^^^^
^^^^^^^^^^((((((###################~~~~##^^^^^^^^^^^^^^^^^^^^^^^^^^^^^^^^^^^^^^^^^^^^^^^^^^^^^^^^^^^
^^^^^^^^^^(((((####################~~~~##^^^^^^^^^^^^^^^^^^^^^^^^^^^^^^^^^^^^^^^^^^^^^^^^^^^^^^^^^^^
^^^^^^^^^^((((####################~~~~##^^^^^^^^^^^^^^^^^^^^^^^^^^^^^^^^^^^^^^^^^^^^^^^^^^^^^^^^^^^^
^^^^^^^^^^((((####################~~~~##vvvvvvvvvvvvvv^^^^^^^^^^^^^^^^^^^^^^^^^^^^^^^^^^^^^^^^^^^^^^
^^^^^^^^^^^(((###################~~~~##^^^^^^^^^^v^^^vvvvvvvvvvvvvvvv^^^^^^^^^^^^^^^^^^^^^^^^^^^^^^^
^^^^^^^^^^^((####################~~~~##^^^^^^^^^^v^^^^^^^^^^^^^^^^^^vvvvvvvvvvvvvvv^^^^^^^^^^^^^^^^^
^^^^^^^^^^^((####################~~~~##^^^^^^^^^^v^^^^^^^^^^^^^^^^^^^^^v^^^^^^^^^^vvvvvvvvvvvv^^^^^^
^^^^^^^^^^^((####################~~~~##^^^^^^^^^vv^^^^^^^^^^^^^^^^^^^^vv^^^^^^^^^^^^^^^^^^v^^vvvvvvv
^^^^^^^^^^^^(###################~~~~##^^^^^^^^^^v^^^^^^^^^^^^^^^^^^^^vv^^^^^^^^^^^^^^^^^^vv^^^^^^^^^
^^^^^^^^^^^^(###################~~~~##^^^^^^^^^^v^^^^^^^^^^^^^^^^^^^vv^^^^^^^^^^^^^^^^^^^v^^^^^^^^^^
^^^^^^^^^^^^((##################~~~~##^^^^^^^^^^v^^^^^^^^^^^^^^^^^vvv^^^^^^^^^^^^^^^^^^^^v^^^^^^^^^^
^^^^^^^^^^^^((##################~~~~##^^^^^    ^v^^^^^^^^^^^^^^^^^v^^^^^^^^^^^^^^^^^^^^^vv^^^^^^^^^^
^^^^^^^^^^^^^(#################~~~~##^^^^^^^^     ^^^^^^^^^^^^^^^^v^^^^^^^^^^^^^^^^^^^^^v^^^^^^^^^^^
^^^^^^^^^^^^^(#################~~~~##^^^^^^^^^^^       ^^^^^^^^^^vv^^^^^^^^^^       ^^^^v^^^^^^^^^^^
^^^^^^^^^^^^^((###############~~~~##^^^^^^^^^^^^^^^^^^    A^^^^^^v^^^^^^^^    ~~~~~      ^^^^^^^^^^^
^^^^^^^^^^^^^((###############~~~~##^^^^^^^^^^^^^^^^^^^v^^^^^^^^^v^^^^^^^^^  ~~~~~~~~~~~   ^^^^^^^^^
^^^^^^^^^^^^^^(###############~~~~##^^^^^^^^^^^^^^^^^^^v^^^^^^^^^v^^^^^^^^^^^  ~~~~~~~~   ^^^^^^^^^^
^^^^^^^^^^^^^^((##############~~~~##^^^^^^^^^^^^^^^^^^vvvvvvvvvv^v^^^^^^^^^^^^           ^^^^^^^^^^^
^^^^^^^^^^^^^^((##############~~~~##^^^^^^^^^^^^^^^^^^v^^^^^^^^vvvvv^^^^^^^^^^v^^^^^^^^^A^^^^^^^^^^^
^^^^^^^^^^^^^^((##############~~~~##^^^^^^^^^^^^^^^^^vv^^^^^^^^^^^^vvvvv^^^^^^v^^^^^^^^^^^^^^^^^^^^^
^^^^^^^^^^^^^^((##############~~~~##^^^^^^^^^^^^^^^^^v^^^^^^^^^^^^^^^^^vvvvvvvv^^^^^^^^^^^^^^^^^^^^^
^^^^^^^^^^^^^^^((#############~~~~##^^^^^^^^^^^^^^^^vv^^^^^^^^^^^^^^^^^^^^^^^v^^^^^^^^^^^^^^^^^^^^^^
^^^^^^^^^^^^^^^((############~~~~##^^^^^^^^^^^^^^^^^v^^^^^^^^^^^^^^^^^^^^^^^^v^^^^^^^^^^^^^^^^^^^^^^
^^^^^^^^^^^^^^^(#############~~~~##vvvvvvvvvvvvvvvvvvv^^^^^^^^^^^^^^^^^^^^^^vv^^^^^^^^^^^^^^^^^^^^^^
^^^^^^^^^^^^^^^(#############~~~~##^^^^^^^^^v^^^^^^^^vvvvvvvvvvvvvvvv^^^^^^^v^^^^^^^^^^^^^^^^^^^^^^^
^^^^^^^^^^^^^^^(############~~~~~##^^^^^^^^^vv^^^^^^^^^^^^^^^^^^^^^^vvvvvvvvvvvvvvvv^^^^^^^^^^^^^^^^
^^^^^^^^^^^^^^^(###########~~~=~~~##^^^^^^^^^vvv^^^^^^^^^^^^^^^^^^^^^^^^^^^^^^^^^^^vvvvvvvvvvvvv^^^^
^^^^^^^^^^^^^^^(###########~~===~~##^^^^^^^^^^^v^^^^^^^^^^^^^^^^^^^^^^^^^^^^^^^^^^^^^^^^^^^^^^^^vvvv
^^^^^^^^^^^^^^((##########~~~=A=~~##^^^^^^^A      ^^^^^^^^^^^^^^^^^^^^^^^^^^^^^^^^^^^^^^^^^^^^^^^^^^
^^^^^^^^^^^^^^((##########~~~===~~##^^^^^^^^^^       ^^^^^^^^^^^^^^^^vvvvvv^^^^^^^^A^^^^^^^^^^^^^^^^
^^^^^^^^^^^^^^(###########~~~==~~~##^^^^^^^^^^^^^      vvvvvv^^^^^^vvv^^^^vvv^^^^^^ ^^^^^^^^^^^^^^^^
^^^^^^^^^^^^^^(###########~~~=~~~##^^^^^^^^^^^^^^^^^^^^^^^^^vvvvvv^v^^^^^^^^vv^^^^   ^^^^^^^^^^^^^^^
^^^^^^^^^^^^^((###########~~~~~~~##^^^^^^^^^^^^^^^^^^^^^^^^^^^^^^vvv^^^^^^^^^v^^^     ^^^^^^^^^^^^^^
^^^^^^^^^^^^^(#############~~~~~##^^^^^^^^^^^^^^^^^^^^^^^^^^^^^^^^^v^^^^^^^^^vv^^v^^^^^^^^^^^^^^^^^^
^^^^^^^^^^^^^(#############~~~~##^^^^^^^^^^^^^^^^^^^^^^^^^^^^^^^^^vv^^^^^^^^^^vvvv^^^^^^^^^^^^^^^^^^
^^^^^^^^^^^^^(#############~~~~#^^^^^^^^^^^^^^^^^^^^^^^^^^^^^^^^^vv^^^^^^^^^^^^^^^^^^^^^^^^^^^^^^^^^
^^^^^^^^^^^^^(############~~~~^vvvvvvvvvvvvvvvvvvvvvvvv^^^^^^^^^^v^^^^^^^^^^^^^^^^^^^^^^^^^^^^^^^^^^
^^^^^^^^^^^^((############~~~~^^^^v^^^^^^^^^^^^^^^^^^^vvvvvvvvvvvvvvvvv^^^^^^^^^^^^^^^^^^^^^^^^^^^^^
^^^^^^^^^^^^(#############~~~~^^^^v^^^^^^^^^^^^^^^^^^^^^^^^^^^^^^^^^^^vvvvvvvvvvvvvvvvv^^^^^^^^^^^^^
^^^^^^^^^^^^(############~~~~^^^^^vvvv^^^^^^^^^^^^^^^^^^^^^^^^^^^^^^^^^^^^^^^^^^^^^^^^vvvvvvvvvvv^^^
^^^^^^^^^^^^(############~~~~^^^^^^^^vv^^^^^^^^v^^^^^^^^^^^^^^^^^^^^^^^^^^^^^^^^^^^^^^^^^^^^^^^^vvvv
^^^^^^^^^^^^(############~~~~^^^^^^^^^v^^^^^^^^v^^^^^^vvv^^^^^^^^^^^^^^^^^^^^^^^^^^^^^^^^^^^^^^^^^^^
^^^^^^^^^^^((###########~~~~^^^^^^^^^^vv^^^vvvvv^^^^vvv^v^^^^^^^^^^^vvvvv^^^^^^^^^^^^^^^^^^^^^^^^^^^
^^^^^^^^^^^(############~~~~^^^^^^^^^^^vvvvv^v^^^^^^v^^^vv^^^^^^^vvvv^^^v^^^^^^^^^^^^^^^^^^^^^^^^^^^
^^^^^^^^^^^(############~~~~^^^^^^^^^^^v^^^^^v^^^^^^v^^^^vvvv^^^^v^^^^^^    ^^^^^^^^^^^^^^^^^^^^^^^^
^^^^^^^^^^^(############~~~~^^^^^^^^^^vv^^^^^vvvv^^^v^^^^^v^v^^^vv^^^^^^      ^^^^^^^^^^^^^^^^^^^^^^
^^^^^^^^^^((###########~~~~^^^^^^^^^^^v^^^^^^^^^vvvvv^^^^^v^vvvvv^^^^^^^^^^    A^^^^^^^^^^^^^^^^^^^^
^^^^^^^^^^(############~~~~^^^^^^^^^^^^^^^^^^^^^^^^^^^^^^vv^^^^^^^^^^^^^^^^^^^^^^^^^^^^^^^^^^^^^^^^^
^^^^^^^^^^(############~~~~^^^^^^^^^^^^^^^^^^^^^^^^^^^^^^^^^^^^^^^^^^^^^^^^^^^^^^^^^^^^^^^^^^^^^^^^^
^^^^^^^^^^(###########~~~~^^^^^^^^^^^^^^^^^^^^^^^^^^^^^^^^^^^^^^^^^^^^^^^^^^^^^^^^^^^^^^^^^^^^^^^^^^
