^^^^^^^^^^^^^^^^^^^^^^^                                   ^^^^^^^^^^^^^^^^^^^^^^^^^^^^^^^^^^v^^^^^^^
^^^^^^^^^^^^^^^^^^^^^^^                                   ^^^^^^^^^^^^^^^^^^^^^^^^^^^^^^^^^^v^^^^^^^
^^^^^^^^^^^^^^^^^^^^^^^         !                         ^^^^^^^^^^^^^^^^^^^^^^^^^^^^^^^^^^v^^^^^^^
^^^^^^^^^^^^^^^^^^^^^^^                                   ^^^^^^^^^^^^^^^^^^^^^^^^^^^^^^^^^^v^^^^^^^
^^^^^^^^^A^^^^^^^^^^^^^^                                  ^^^^^^^^^^^^^^^^^^^^^^^^^^^^^^^^^vv^^^^^^^
^^^^^^^^^v^^^^^^^^^^^^^^                                   ^^^^^^^^^^^^^^^^^^^^A^^^^^^^^^^^v^^^^^^^^
^^^^^^^^^v^^^^^^^^^^^^^^                                   ^^^^^^^^^^^^^^^^^^^^v^^^^^^^^^^^v^^^^^^^^
^^^^^^^^^v^^^^^^^^^^^^^^^                      !            ^^^^^^^^^^^^^^^^^^^v^^^^^^^^^^^v^^^^^^^^
^^^^^^^^^vv^^^^^^^^^^^^^^                                   ^^^^^^^^^^^^^^^^^^vv^^^^^^^^^^^v^^^^^^^^
^^^^^^^^^^v^^^^^^^^^^^^^^                                   ^^^^^^^^^^^^^^^^^^v^^^^^^^^^^^vv^^^^^^^^
^^^^^^^^^^v^^^^^^^^^^^^^^^    !                             ^^^^^^^^^^^^^^^^^^v^^^^^^^^^^^v^^^^^^^^^
^^^^^^^^^^v^^^^^^^^^^^^^^^                                   ^^^^^^^^^^^^^^^^^v^^^^^^^^^^^v^^^^^^^^^
^^^^^^^^^^v^^^^^^^^^^^^^^^                                   ^^^^^^^^^^^^^^^^^v^^^^^^^^^^^v^^^^^^^^^
^^^^^^^^^^v^^^^^^^^^^^^^^^^                                  ^^^^^^^^^^^^^^^^vv^^^^^^^^^^vv^^^^^^^^^
^^^^^^^^^^v^^^^^^^^^^^^^^^^                                  ^^^^^^^^^^^^^^^^v^^^^^^^^^^^v^^^^^^^^^^
^^^^^^^^^^v^^^^^^^^^^^^^^^^                                   ^^^^^^^^^^^^^^^v^^^^^^^^^^^v^^^^^^^^^^
^^^^^^^^^^vv^^^^^^^^^^^^^^^^            !                     ^^^^^^^^^^^^^^^v^^^^^^^^^^^v^^^^^^^^^^
^^^^^^^^^^^v^^^^^^^^^^^^^^^^                                  ^^^^^^^^^^^^^Avv^^^^^^^^^^^v^^^^^^^^^^
^^^^^^^^^^^v^^^^^^^^^^^^^^^^                           !       ^^^^^^^^^^^^^^v^^^^^^^^^^vv^^^^^^^^^^
^^^^^^^^^^^v^^^^^^^^^^^^^^^^                                   ^^^^^^^^^^^^^^v^^^^^^^^^^v^^^^^^^^^^^
^^^^^^^^^^^vv^^^^^^^^^^^^^^^                                   ^^^^^^^^^^^^^^v^^^^^^^^^^v^^^^^^^^^^^
^^^^^^^^^^^^v^^^^^^^^^^^^^^^                                   ^^^^^^^^^^^^^vv^^^^^^^^^^v^^^^^^^^^^^
^^^^^^^^^^^^v^^^^^^^^^^^^^^^^                                  ^^^^^^^^^^^^^v^^^^^^^^^^^v^^^^^^^^^^^
^^^^^^^^^^^^v^^^^^^^^^^^^^^^^                                  ^^^^^^^^^^^^^v^^^^^^^^^^^v^^^^^^^^^^^
^^^^^^^^^^^^vv^^^^^^^^^^^^^^^                                  ^^^^^^^^^^^^^v^^^^^^^^^^^vv^^^^^^^^^^
^^^^^^^^^^^^^v^^^^^^^^^^^^^^^                                   ^^^^^^^^^^^^v^^^^^^^^^^^^v^^^^^^^^^^
^^^^^^^^^^^^^v^^^^^^^^^^^^^^^                                   ^^^^^^^^^^^^v^^^^^^^^^^^^vv^^^^^^^^^
^^^^^^^^^^^^^v^^^^^^^^^^^^^^^^                                  ^^^^^^^^^^^^v^^^^^^^^^^^^^v^^^^^^^^^
^^^^^^^^^^^^^vv^^^^^^^^^^^^^^^^                !                ^^^^^^^^^^^vv^^^^^^^^^^^^^v^^^^^^^^^
^^^^^^^^^^^^^^v^^^^^^^^^^^^^^^^                          !      ^^^^^^^^^^^v^^^^^^^^^^^^^^vv^^^^^^^^
^^^^^^^^^^^^^^v^^^^^^^^^^^^^^^^     !                           ^^^^^^^^^^^v^^^^^^^^^^^^^^^v^^^^^^^^
^^^^^^^^^^^^^^vv^^^^^^^^^^^^^^^                                ^^^^^^^^^^^^v^^^^^^^^^^^^^^^v^^^^^~~~
^^^^^^^^^^^^^^^v^^^^^^^^^^^^^^^^                               ^^^^^^^^^^^^v^^^^^^^^^^^^^^^###~~~~~~
^^^^^^^^^^^^^^^v^^^^^^^^^^^^^^^^                               ^^^^^^^^^^^^v^^^^^^^^^^^^^^##~~~~~~~~
^^^^^^^^^^^^^^^vv^^^^^^^^^^^^^^^                               ^^^^^^^^^^^vv^^^^^^^^^^^^^^~~~~~~~~~~
^^^^^^^^^^^^^^^^v^^^^^^^^^^^^^^^^                              ^^^^^^^^^^^v^^^^^^^^^^^^^~~~~~~~~~^^^
^^^^^^^^^^^^^^^^vv^^^^^^^^^^^^^^^                             ^^^^^^^^^^vvv^^^^^^^^^^^~~~~~~~~^^^^^^
^^^^^^^^^^^^^^^^^v^^^^^^^^^^^^^^^^                            ^^^^^^^^^^v^^^^^^^^^^^~~~~~~~~^^^^^^^^
^^^^^^^^^^^^^^^vvv^^^^^^^^^^^^^^^^                           ^^^^^^^^^^^v^^^^^^^^^~~~~~~~~^^^^^^^^^^
^^^^^^^^^^^^^^vv^vv^^^^^^^^^^^^^^^^       !            !     ^^^^^^^^^vvv^^^^^^^~~~~~~~~^^^^^^^^^^^^
^^^^^^^^^^^^^^v^^^vvv^^^^^^^^^^^^^^^                         ^^^^^^vvvv^^^^^^~~~~~~~~~^^^^^^^^^^^^^^
^^^^^^^^^^^^^^v^^^^^vvv^^^^^^^^^^^^^                         ^^^vvvv^^^^^^~~~~~~~~~~^^^^^^^^^^^^^^^^
^^^^^^^^^^^^^^v^^^^^^^vvv^^^^^^^^^^^^                        vvvv^^^^^^^~~~~~~~~~~^^^^^^^^^^^^^^^^^^
^^^^^^^^^^^^^vv^^^^^^^^^vvv^^^^^^^^^^                        ^^^^^^^^^~~~~~~~~~~^^^^^^^^^^^^^^^^^^^^
^^^^^^^^^^^^vv^^^^^^^^^^^^vvvv^^^^^^^^^                     ^^^^^^^^~~~~~~~~~^^^^^^^^^^^^^^^^^^^^^^^
^^^^^^^^^^vvv^^^^^^^^^^^^^^^^vvvv^^^^^^^           !        ^^^^^~~~~~~~~~^^^^^^^^^^^^^^^^^^^^^^^^^^
^^^^^^^^^^v^^^^^^^^^^^^^^^^^^^^^vvvvv^^^^^                  ^^~~~~~~~~~~^^^^^^^^^^^^^^^^^^^^^^^^^^^^
^^^^^^^^^^v^^^^^^^^^^^^^^^^^^^^^^^^^vvv^^^^              ~~~~~~~~~~~~~^^^^^^^^^^^^^^^^^^^^^^^^^^^^^^
^^^^^^^^    ^^^^^^^^^^^^^^^^^^^^^^^^^^vvvvvv^        ~~~~~~~~~~~~~~~^^^^^^^^^^^^^^^^^^^^^^^^^^^^^^^^
^^^^^^^^     ^^^^^^^^^^^^^^^^^^^^^^^^^^^^^^^^^^^~~~~~~~~~~~~~~~~~^^^^^^^^^^^^^^^vvvvvv^^^^^^^^^^^^^^
^^^^^^^     ^^^^^^^^^^^^^^^^^^^^^^^^^^^^^^^~~~~~~~~~~~~~~~~~~~^^^^^^^^^^^^^^^^^^v^^^^vvvv^^^^^^^^^^^
^^^^^^     ^^^^^^^^^^^^^^^^^^^^^^^^^^^~~~~~~~~~~~~~~~~~~~     ^^^^^^^^^^^^^^^^^^v^^^^^^^vvv^^^^^^^^^
^^^^^^^   ^^^^^^^^^^^^^^^^^^^^^^^^~~~~~~~~~~~~~~~~~~~~~~1      ^^^^^^^^^^^^^^^^^v^^^^^^^^^vv^^^^^^^^
^^^^^^^^A^^^^^^^^^^^^^^^^^^^^^~~~~~~~~~~~~~~~~~~~~~~~~~~~      ^^^^^^^^^^^^^^^^^v^^^^^^^^^^v^^^^^^^^
^^^^^^^^^^^^^^^^^^^^^^^^^^~~~~~~~~~~~~~~~~~~~~~~^^^^^^~~~~      ^^^^^^^^^^^^^^vvv^^^^^^^^^^v^^^^^^^^
^^^^^^^^^^^^^^^^^^^^~~~~~~~~~~~~~~~~~~~~~~~^^^^^^^^^^^^~~~~     ^^^^^^^^^^^^^^v^^^^^^^^^^^^v^^^^^^^^
^^^^^^^^^^^^^^~~~~~~~~~~~~~~~~~~~~~~~~^^^^^^^^^^^^^^^^^^~~~~     ^^^^^^^^^^^^^v^^^^^^^^^^^^vv^^^^^^^
^^^^^^^~~~~~~~~~~~~~~~~~~~~~~~~~~~^^^^^^^^^^^^^^^^^^^^^^~~~~      ^^^^^^^^^^^^v^^^^^^^^^^^^^v^^^^^^^
~~~~~~~~~~~~~~~~~~~~~~~~~~~~~~^^^^^^^^^^^^^^^^^^^^^^^^^^^~~~~     ^^^^^^^^^^^vv^^^^^^^^^^^^^v^^^^^^^
~~~~~~~~~~~~~~~~~~~~~~~~~~^^^^^^^^^^^^^^^^^^^^^^^^^^^^^^^^~~~~     ^^^^^^^^^^v^^^^^^^^^^^^^^v^^^^^^^
~~~~~~~~~~~~~~~~~~~~^^^^^^^^^^^^^^^^^^^^^^^^^^^^^^^^^^^^^^~~~~     ^^^^^^^^^vv^^^^^^^^^^^^^^v^^^^^^^
~~~~~~~~~~~~~~^^^^^^^^^^^^^^^^^^^^^^^^^^^^^^^^^^^^^^^^^^^^^~~~~   ^^^^^^^^^vv^^^^^^^^^^^^^^vv^^^^^^^
~~~~~~~^^^^^^^^^^^^^^^^^^^^^^^^^^^^^^^^^^^^^^^^^^^^^^^^^^^^~~~~   ^^^^^^^^^v^^^^^^^^^^^^^^^v^^^^^^^^
^^^^^^^^^^^^^^^^^^^^^^^^^^^^^^^^^^^^^^^^^^^^^^^^^^^^^^^^^^^^~~~~  ^^^^^^^^^v^^^^^^^^^^^^^^^v^^^^^^^^
^^^^^^^^^^^^^^^^^^^^^^^^^^^^^^^^^^^^^^^^^^^^^^^^^^^^^^^^^^^^~~~~  ^^^^^^^^vv^^^^^^^^^^^^^^^v^^^^^^^^
^^^^^^^^^^^^^^^^^^^^^^^^^^^^^^^^^^^^^^^^^^^^^^^^^^^^^^^^^^^^^~~~~ ^^^^vvvvv^^^^^^^^^^^^^^^vv^^^^^^^^
^^^^^^^^^^^^^^^^^^^^^^^^^^^^^^^^^^^^^^^^^^^^^^^^^^^^^^^^^^^^^~~~~ vvvvv^^^^^^^^^^^^^^^^^^^v^^^^^^^^^
^^^^^^^^^^^^^^^^^^^^^^^^^^^^^^^^^^^^^^^^^vvvvvv^^^^^^^^^^^^^^^~~~~^^^^^^^^^^^^^^^^^^^^^^^^v^^^^^^^^^
^^^^^^^^^^^^^^^^^^^^^^^^^^^^^^^^^^^^^^^^^v^^^^vvvv^^^^^^^^^^^^~~~~^^^^^^^^^^^^^^^^^^^^^^^vv^^^^^^^^^
^^^^^^^^^^^^^^^^^^^^^^^^^^^^^^^^^^^^^^^^vv^^^^^^^vv  ^^^^^^^^^~~~~^^^^^^^^^^^^^^^^^^^^^^^v^^^^^^^^^^
^^^^^^^^^^^^^^^^^^^^^^^^^^^^^^^^^^^^^^^^v^^^^^^^^^^^  ^^^^^^^^^~~~~^^^^^^^^^^^^^^^^^^^^^^v^^^^^^^^^^
^^^^^^^^^^^^^^^^^^^^^^^^^^^^^^^^^^^^^^^^v^^^^^^^^^^^^  ^^^^^^^^^~~~~^^^^^^^^^^^^^^^^^^^^^ ^^^^^^^^^^
^^^^^^^^^^^^^^^^^^^^^^^^^^^^^^^^^^^^^^^vv^^^^^^^^^^^^^ ^^^^^^^^^^~~~~^^^^^^^^^^^^^^^^^^^   ^^^^^^^^^
^^^^^^^^^^^^^^^^^^^^^^^^^^^^^^^^^^^^^^^v^^^^^^^^^^^^^^ ^^^^^^^^^^^~~~~^^^^^^^^^^^^^^^^^^   ^^^^^^^^^
^^^^^^^^^^^^^^^^^^^^^^^^^^^^^^^^^^^^^^vv^^^^^^^^^^^^^^ ^^^^^^^^^^^^~~~~^^^^^^^^^^^^^^^^^^A^^^^^^^^^^
^^^^^^^^^^^^^^^^^^^^^^^^^^^^^^^^^^^^^^v^^^^^^^^^^^^^^^ ^^^^^^^^^^^^^~~~~^^^^^^^^^^^^^^^^^^^^^^^^^^^^
^^^^^^^^^^^^^^^^^^^^^^^^^^^^^^^^^^^^^vv^^^^^^^^^^^^^^  ^^^^^^^^^^^^^~~~~^^^^^^^^^^^^^^^^^^^^^^^^^^^^
^^^^^^^^^^^^^^^^^^^^^^^^^^^^^^^^^^^^^v^^^^^^^^^^^^^^  ^^^^^^^^^^^^^^^~~~~^^^^^^^^^^^^^^^^^^^^^^^^^^^
^^^^^^^^^^^^^^^^^^^^^^^^^^^^^^^^^^^^^v^^^^^^^^^^^^^  ^^^^^^^^^^^^^^^^~~~~^^^^^^^^^^^^^^^^^^^^^^^^^^^
^^^^^^^^^^^^^^^^^^^^^^^^^^^^^^^^^^^^^v^^^^^^^^^^^^  ^^^^^^^^^^^^^^^^^^~~~~^^^^^^^^^^^^^^^^^^^^^^^^^^
^^^^^^^^^^^^^^^^^^^^^^^^^^^^^^^^^^^^^vv^^^^^^^^^A  ^^^^^^^^^^^^^^^^^^^~~~~^^^^^^^^^^^^^^^^^^^^^^^^^^
^^^^^^^^^^^^^^^^^^^^^^^^^^^^^^^^^^^^^^v^^^^^^^^^^^^^^^^^^^^^^^^^^^^^^^^~~~~^^^^^^^^^^^^^^^^^^^^^^^^^
^^^^^^^^^^^^^^^^^^^^^^^^^^^^^^^^^^^^^^v^^^^^^^^^^^^^^^^^^^^^^^^^^^^^^^^^~~~~^^^^^^^^^^^^^^^^^^^^^^^^
^^^^^^^^^^^^^^^^^^^^^^^^^^^^^^^^^^^^^^vv^^^^^^^^^^^^^^^^^^^^^^^^^^^^^^^^~~~~^^^^^^^^^^^^^^^^^^^^^^^^
^^^^^^^^^^^^^^^^^^^^^^^^^^^^^^^^^^^^^^^v^^^^^^^^^^^^^^^^^^^^^^^^^^^^^^^~~~~^^^^^^^^^^^^^^^^^^^^^^^^^
^^^^^^^^^^^^^^^^^^^^^^^^^^^^^^^^^^^^^^^v^^^^^^^^^^^^^^^^^^^^^^^^^^^^^^~~~~^^^^^^^^^^^^^^^^^^^^^^^^^^
^^^^^^^^^^^^^^^^^^^^^^^^^^^^^^^^^^^^^^^v^^^^^^^^^^^^^^^^^^^^^^^^^^^^^~~~~^^^^^^^^^^^^^^^^^^^^^^^^^^^
^^^^^^^^^^^^^^^^^^^^^^^^^^^^^^^^^^^^^^^v^^^^^^^^^^^^^^^^^^^^^^^^^^^^~~~~^^^^^^^^^^^^^^^^^^^^^^^^^^^^
^^^^^^^^^^^^^^^^^^^^^^^^^^^^^^^^^^^^^^^ ^^^^^^^^^^^^^^^^^^^^^^^^^^^~~~~^^^^^^^^^^^^^^^^^^^^^^^^^^^^^
^^^^^^^~~~~~~~^^^^^^^^^^^^^^^^^^^^^^^^   ^^^^^^~~~~~^^^^^^^^^^^^~~~~~~~^^^^^^^^^^^^^^^^^^^^^^^^^^^^^
^~~~~~~~~~~~~~~~~^^^^^^^^^^^^^^^^^^~~~~~~~^^^^~~~~~~~^^^^^^^^~~~~~~~~~~~~~^^^^^^^^^^^^^^^^^~~~~~~^^^
~~~~~~~~~~~~~~~~~~~^^^^^^^^^^^^^~~~~~~~~~~~~~~~~~~~~~~^^^^^^~~~~~~~~~~~~~~~~^^^^^^^^^^~~~~~~~~~~~~~~
~~~~~~~~~~~~~~~~~~~~~~~~~~^^^^~~~~~~~~~~~~~~~~~~~~~~~~~~^^^~~~~~~~~~~~~~~~~~~~~~~~~~~~~~~~~~~~~~~~~~
~~~~~~~~~~~~~~~~~~~~~~~~~~~~~~~~~~~~~~~~~~~~~~~~~~~~~~~~~~~~~~~~~~~~~~~~~~~~~~~~~~~~~~~~~~~~~~~~~~~~
~~~~~~~~~~~~~~~~~~~~~~~~~~~~~~~~~~~~~~~~~~~~~~~~~~~~~~~~~~~~~~~~~~~~~~~~~~~~~~~~~~~~~~~~~~~~~~~~~~~~
~~~~~~~~~~~~~~~~~~~~~~~~~~~~~~~~~~~~~~~~~~~~~~~~~~~~~~~~~~~~~~~~~~~~~~~~~~~~~~~~~~~~~~~~~~~~~~~~~~~~
~~~~~~~~~~~~~~~~~~~~~~~~~~~~~~~~~~~~~~~~~~~~~~~~~~~~~~~~~~~~~~~~~~~~~~~~~~~~~~~~~~~~~~~~~~~~~~~~~~~~
~~~~~~~~~~~~~~~~~~~~~~~~~~~~~~~~~~~~~~~~~~~~~~~~~~~~~~~~~~~~~~~~~~~~~~~~~~~~~~~~~~~~~~~~~~~~~~~~~~~~
~~~~~~~~~~~~~~~~~~~~~~~~~~~~~~~~~~~~~~~~~~~~~~~~~~~~~~~~~~~~~~~~~~~~~~~~~~~~~~~~~~~~~~~~~~~~~~~~~~~~
~~~~~~~~~~~~~~~~~~~~~~~~~~~~~~~~~~~~~~~~~~~~~~~~~~~~~~~~~~~~~~~~~~~~~~~~~~~~~~~~~~~~~~~~~~~~~~~~~~~~
