^^^^^^^^^(############~~~~^^^^^^^^^^^^^^^^^^^^^^^^^^^^^^^^^^^^^^^^^^^^^^^^^^^^^^^^^^^^^^^^^^^^^^^^^^
^^^^^^^^^(############~~~~^^^^^^^^^^^^^^^^^^^^^^^^^^^^^^^^^^^^^^^^^^^^^^^^^^^^^^^^^^^^^^^^^^^^^^^^^^
^^^^^^^^^(############~~~~^^^^^^^^^^^^^^^^^^^^^^^^^^^^^^^^^^^^^^^^^^^^vvvvvvv^^^^^^^^^^^^^^^^^^^^^^^
^^^^^^^^^(############~~~~^^^^^^^^^^^^^^^^^^^^^^^^^^^^^^^^^^^^^^^^^^^^v^^^^^vvvvv^^^^^^^^^^^^^^^^^^^
^^^^^^^^^(############~~~~^^^^^^^^^^^^^^^^^^^^^^^^^^^^^^^^^^^^^^^^vvvvv^^^^^^^^^vvvvvv^^^vvvv^^^^^^^
^^^^^^^^^(############~~~~^^^^^^^^^^^^^^^^^^^^^^^^^^^^^^^^^^^^^^^^v^^^^^^^^^^^^^^^^^^vvvvv^^v^^^^^^^
^^^^^^^^^(###########~~~~((---------((((                ^^^^^^^^^^v^^^^^^^^^^^^^^^^^^^^^^^^^v^^^^^^^
^^^^^^^^^(###########~~~~((--------((((                  ((((-----------^^^^^^^^^^^^^^^^^^^^vvA^^^^^
^^^^^^^^((###########~~~~((-A-------((                    (((((-------------------^^^^^^^^^^^^^^^^^^
^^^^^^^^(############~~~~((---------((                      (((((-----------------------^^^^^^^^^^^^
^^^^^^^((############~~~~((--------((                         ((((((--------------------^^^^^^^^^^^^
^^^^^^^(#############~~~~((--------((                           (((((((-------------------^^^^^^^^^^
^^^^^^^(############~~~~((--------((                              (((((((-----------------^^^^^^^^^^
^^^^^^^(############~~~~((-------((                                 ((((((-----------------^^^^^^^^^
^^^^^^((############~~~~((-----(((                                    ((((((--------------^^^^^^^^^^
^^^^^^(#############~~~~((-((((((                                       ((((((-----------^^^^^^^^^^^
^^^^^^(############~~~~((((((((                                           ((((((-----------^^^^^^^^^
^^^^^^^(###########~~~~(((((                                                 (((((---------^^^^^^^^^
^^^^^^^(###########~~~~                                                        ((((---------^^^^^^^^
^^^^^^^(###########~~~~                        ((((((((((                       ((((-------^^^^^^^^^
^^^^^^^(##########~~~~                        (((((((((((((((((                  (((((------^^^^^^^^
^^^^^^^(##########~~~~                       ((((((((((((((((((((((                ((((------^^^^^^^
^^^^^^(##########~~~~~                       (((((((((((((((((((((((                ((((----^^^^^^^^
^^^^^^(##########~~~~~#                        ((((((((((((((((((((((                ((((--^^^^^^^^^
^^^^^^(#########~~~~~##                         ((((((((((((((((((((((                ((((^^^^^^^^^^
^^^^^^(#########~~~~~####                         ((((((((((((((((((((((                ((^^^^^^^^^^
^^^^^^(#########~~~~~######                        ((((((((((((((((((((((                ((^^^^^^^^^
^^^^^(##########~~~~~#########                      ((((((((((((((((((((((                ((^^^^^^^^
^^^^^(#######~~~~~~~#############                    ((((((((((A((((((((((                 (((^^^^^^
^^^^^(###~~~~~~~~~~~################                 (((((((((((((((((((((                  ((^^^^^^
^^^^^~~~~~~~~~~~~~~~##################                (((((((((((((((((((((                  ^^^^^^^
~~~~~~~~~~~~~~~~~~~####============#####               ((((((((((((((((((((                  ^^^^^^^
~~~~~~~~~~~~~~~~#####================####              ((((((((((((((((((((                 ^^^^^^^^
~~~~~~~~~~~   #######=================###               ((((((((((((((((((((                ^^^^^^^^
~~~~~~          ###=================#####                (((((((((((((((((((                 ^^^^^^^
^^^^            ######================####                ((((((((((((((((((                  ^^^^^^
^^^^               ####================####               (((((((((((((((((                   ^^^^^^
^^^^^                ###================####              (((((((((((((((((                  ^^^^^^^
^^^^^                  ###===============###               ((((((((((((((((                  ^^^^^^^
^^^^^                 #####======A======####               (((((((((((((((                   ^^^^^^^
^^^^^^               ####===============####               (((((((((((((((                  ^^^^^^^^
^^^^^^               ###=================#####             (((((((((((((((                  ^^^^^^^^
^^^^^^               ####==================###            (((((((((((((((                   ^^^^^^^^
^^^^^^                ####==================###           (((((((((((((((                  ^^^^^^^^^
^^^^^^^                ####================###            ((((((((((((((                  ^^^^^^^^^^
^^^^^^^                 ####==============###            (((((((((((((                    ^^^^^^^^^^
^^^^^^^                   #####=======#####             (((((((((((                      ^^^^^^^^^^^
^^^^^^^                     #############                                                ^^^^^^^^^^^
^^^^^^^^                      ##########                                                 ^^^^^^^^^^^
^^^^^^^^                                                                                ^^^^^^^^^^^^
^^^^^^^^                                                                                ^^^^^^^^^^^^
^^^^^^^^^                                                                               ^^^^^^^^^^^^
^^^^^^^^^                                                                              ^^^^^^^^^^^^^
^^^^^^^^^                                                                              ^^^^^^^^^^^^^
^^^^^^^^^^                                                                             ^^^^^^^^^^^^^
^^^^^^^^^^                                                                            ^^^^^^^^^^^^^^
^^^^^^^^^^                                                                            ^^^^^^^^^^^^^^
^^^^^^^^^^^                                               ^^^^^^                      ^^^^^^^^^^^^^^
^^^^^^^^^^^^                                            ^^^^^^^^^^^^                  ^^^^^^^^^^^^^^
^^^^^^^^^^^^^                              ^^^         ^^^^^~~~~~^^^^^                ^^^^^^^^^^^^^^
^^^^^^^^^^^^^^                             ^A^        ^^^^   ~~~~~~A^^^                ^^^^^^^^^^^^^
^^^^^^^^^^^^^^                             ^v^        ^^^     ~~~~~ ^^^                ^^^^^^^^^^^^^
^^^^^^^^^^^^vvv                                       ^^^^     ~~~~~ ^^^               ^^^^^^^^^^^^^
^^^^^^^^^^^vv^^^                                     ^^^^      ~~~~~ ^^^               (^^^^^^^^^^^^
^^^^^^^^^^vv^^^^^                                    ^^^^       ~~~~ ^^^               ((^^^^^^^^^^^
^^^^^^^^^^v^^^^^^^                                    ^^^^       ~  ^^^                (((^^^^^^^^^^
^^^^^^^^^^v^^^^^^^^                                    ^^^^       ^^^^                  (((^^^^^^^^^
^^^^^^^^^^v^^^^^^^^^                                     ^^^^   ^^^^                    (((^^^^^^^^^
^^^^^^^^^^vv^^^^^^^^^                                     ^^^^^^^^^                    ((((^^^^^^^^^
^^^^^^^^^^^vvvvvv^^^^^^                                     ^^^^^                      (((^^^^^^^^^^
^^^v^^^^^^^v^^^^vvv^^^^^^                                                              (((^^^^^^^^^^
^^^v^^^^^^^v^^^^^^vv^^^^^^^                                                           ((((^^^^^^^^^^
^^^v^^^^^^vvv^^^^^^v^^^^^^^^^                                                        ((((-^^^^^^^^^^
^^^vvv^^vvv^v^^^^^^vvvvvv^^^^^^                                                     ((((--^^^^^^^^^^
^^^^^vvvv^^^vv^^^^^^^^v^vv^^^^^^^                                                  ((((--^^^^^^^^^^^
^^^^^^v^^^^^^v^^^^^^^^v^^v^^^^vv^^^                                              (((((---^^^^^^^^^^^
^^^vvvv^^vv^^vv^^^^^vvv^^v^^^^^v^^^^^                                          ((((((----^^^^^^^^^^^
^vvv^^v^^v^^^^v^^^^^^^^^^v^^^^^v^^^^^^^^                                      (((((------^^^^^^^^^^^
^v^^^^vvvv^^^^v^^^^^^^^^^^^^^vvv^^^^^^^^^^^                                  (((((-------^^^^^^^^^^^
^v^^^^^^^^^^^^vvvvvv^^^^^^^vvv^^^^^^^^^^^^^^^^                             ((((((-------^^^^^^^^^^^^
^^^^^^^^^^^^^^^v^^^v^^^^^^vv^v^^^^^^^^v^^^^^^^^^^^                       ((((((--------^^^^^^^^^^^^^
^^^^^^^vvvv^^^^v^^^vvvv^^vv^^v^^^^^^^vv^^^^^^^^^^^^^^^^                 ((((((--------^^^^^^^^^^^^^^
^^^^^vvv^^v^^vvv^^^^^^vvvv^^^vvvv^^^vv^^^^^^^^^^^^^^^^^^^^^            (((((---------^^^^^^^^^^^^^^^
^^^vvv^vv^vvvv^^^^^^^vv^v^^^^^^^vvvvv^^^^^^^^^^^^^^^^^^^^^^^^^        ((((-----------^^^^^^^^^^^^^^^
^^^v^^^^v^^^^^^^^^^^vv^^v^^^^^^^^^^^^^^^^^^^^^^^^^^^^^^^^^^^^^^^^    (((--------------^^^^^^^^^^^^^^
^^^v^^^^v^^^^^^^vvvvv^^^vvv^^^^^^^^^^^^^^^^^^^^^^^^^^^^^^^^^^^^^^^^  ((----------------^^^^^^^^^^^^^
^^^vv^^^v^^^vvvvv^^^^^^^^^vv^^^^^^^^^^^^^^^^^^^^^^^^^^^^^^^^^^^^^^^^^^(-----------------^^^^^^^^^^^^
^^^^^^^^vv^^A^^^^^^^^^^^^^^vvvv^^^^^^^v^^^^^^^^^^^^^^^^^^^^^^^^^^^^^^^^^^----------------^^^^^^^^^^^
^^^^^^^^^^^^^^^^^^^^^^^^^^^^^^vvvv^vvvv^^^^^^^^^^^^^^^^^^^^^^^^^^^^^^^^^^^^^^-------------^^^^^^^^^^
^^^^^^^^^^^^^^^^^^^^^^~~^^^^^^^^^vvv^^^^^^^^^^^^^^^^^^^^^^^^^^^^^^^^^^^^^^^^^^^^^^---------^^^^^^^^^
^^^^^^^^^^^^^^^^^^^^^~~~~^^^^^^^^^^^^^^^^^^^^^^^^^^^^^^^^^^^^^^^^^^^^^^^^^^^^^^^^^^^^^-----^^^^^^^^^
~~~~~^^^^^^^^^^^^^^^~~~~~~~~^^^^^^^^^^^^^^^^^^^^^^^^^^^^^^^^^^^^^^^^^^^^^^^^^^^^^^^^^^^^^^-----A^^^^
~~~~~~~^^^^^^^^^^^~~~~~~~~~~~~^^^^^^^^^^~~~~~~~~^^^^^^~~~~~^^^^^^^^^^~~~~^^~~^^^^^^^^^^^^^^^^^^^^^^^
~~~~~~~~~~^^^^^~~~~~~~~~~~~~~~~~~^^^~~~~~~~~~~~~~^^^^~~~~~~~~~~~^^^~~~~~~~~~~~~^^^^^^^^^^^^^^^^^^^^^
~~~~~~~~~~~~~~~~~~~~~~~~~~~~~~~~~~~~~~~~~~~~~~~~~~^^~~~~~~~~~~~~~~~~~~~~~~~~~~~~~~~~~~~~~~~~~~~~~~~~
~~~~~~~~~~~~~~~~~~~~~~~~~~~~~~~~~~~~~~~~~~~~~~~~~~~~~~~~~~~~~~~~~~~~~~~~~~~~~~~~~~~~~~~~~~~~~~~~~~~~
~~~~~~~~~~~~~~~~~~~~~~~~~~~~~~~~~~~~~~~~~~~~~~~~~~~~~~~~~~~~~~~~~~~~~~~~~~~~~~~~~~~~~~~~~~~~~~~~~~~~
~~~~~~~~~~~~~~~~~~~~~~~~~~~~~~~~~~~~~~~~~~~~~~~~~~~~~~~~~~~~~~~~~~~~~~~~~~~~~~~~~~~~~~~~~~~~~~~~~~~~
~~~~~~~~~~~~~~~~~~~~~~~~~~~~~~~~~~~~~~~~~~~~~~~~~~~~~~~~~~~~~~~~~~~~~~~~~~~~~~~~~~~~~~~~~~~~~~~~~~~~
~~~~~~~~~~~~~~~~~~~~~~~~~~~~~~~~~~~~~~~~~~~~~~~~~~~~~~~~~~~~~~~~~~~~~~~~~~~~~~~~~~~~~~~~~~~~~~~~~~~~
